# entries to be added to the postag database
Achterheide	Achterheide	ENM:LOC:PTS
Ardooie	Ardooie	ENM:LOC:PTS
Atjeh	Atjeh	ENM:LOC:PTS
Avereest	Avereest	ENM:LOC:PTS
Berchem	Berchem	ENM:LOC:PTS
Berlijn	Berlijn	ENM:LOC:PTS
Genua	Genua	ENM:LOC:PTS
Luik	Luik	ENM:LOC:PTS
Middelkerken	Middelkerken	ENM:LOC:PTS
München	München	ENM:LOC:PTS
Stockholm	Stockholm	ENM:LOC:PTS
Trinidad	Trinidad	ENM:LOC:PTS
Zaanstad	Zaanstad	ENM:LOC:PTS
Zichem	Zichem	ENM:LOC:PTS
Zijpe	Zijpe	ENM:LOC:PTS
artikelgewijs	artikelgewijs	BNW:STL:ONV
elders	elders	BYW
eventjes	eventjes	BYW
ge-sms	ge-sms	ZNW:EKV:HET
geaai	geaai	ZNW:EKV:HET
geaard	geaard	ZNW:EKV:HET
geaarzel	geaarzel	ZNW:EKV:HET
geacht	geacht	ZNW:EKV:HET
geacteer	geacteer	ZNW:EKV:HET
geactiveer	geactiveer	ZNW:EKV:HET
geadem	geadem	ZNW:EKV:HET
geadopteer	geadopteer	ZNW:EKV:HET
geadoreer	geadoreer	ZNW:EKV:HET
geadviseer	geadviseer	ZNW:EKV:HET
geageer	geageer	ZNW:EKV:HET
gealarmeer	gealarmeer	ZNW:EKV:HET
geamendeer	geamendeer	ZNW:EKV:HET
geanalyseer	geanalyseer	ZNW:EKV:HET
geanker	geanker	ZNW:EKV:HET
geantwoord	geantwoord	ZNW:EKV:HET
geapp	geapp	ZNW:EKV:HET
gearbeid	gearbeid	ZNW:EKV:HET
geargumenteer	geargumenteer	ZNW:EKV:HET
gearrangeer	gearrangeer	ZNW:EKV:HET
gearresteer	gearresteer	ZNW:EKV:HET
geautopet	geautopet	ZNW:EKV:HET
gebaad	gebaad	ZNW:EKV:HET
gebaat	gebaat	ZNW:EKV:HET
gebabbel	gebabbel	ZNW:EKV:HET
gebabysit	gebabysit	ZNW:EKV:HET
gebackpack	gebackpack	ZNW:EKV:HET
gebadder	gebadder	ZNW:EKV:HET
gebagatelliseer	gebagatelliseer	ZNW:EKV:HET
gebagger	gebagger	ZNW:EKV:HET
gebakkelei	gebakkelei	ZNW:EKV:HET
gebal	gebal	ZNW:EKV:HET
gebalanceer	gebalanceer	ZNW:EKV:HET
gebalder	gebalder	ZNW:EKV:HET
gebalk	gebalk	ZNW:EKV:HET
geballast	geballast	ZNW:EKV:HET
gebalts	gebalts	ZNW:EKV:HET
gebanjer	gebanjer	ZNW:EKV:HET
gebarst	gebarst	ZNW:EKV:HET
gebas	gebas	ZNW:EKV:HET
gebaseer	gebaseer	ZNW:EKV:HET
gebasket	gebasket	ZNW:EKV:HET
gebat	gebat	ZNW:EKV:HET
gebauw	gebauw	ZNW:EKV:HET
gebazel	gebazel	ZNW:EKV:HET
gebedel	gebedel	ZNW:EKV:HET
gebedil	gebedil	ZNW:EKV:HET
gebedrieg	gebedrieg	ZNW:EKV:HET
gebeef	gebeef	ZNW:EKV:HET
gebef	gebef	ZNW:EKV:HET
gebegeleid	gebegeleid	ZNW:EKV:HET
gebeid	gebeid	ZNW:EKV:HET
gebeier	gebeier	ZNW:EKV:HET
gebeitel	gebeitel	ZNW:EKV:HET
gebek	gebek	ZNW:EKV:HET
gebekvecht	gebekvecht	ZNW:EKV:HET
gebel	gebel	ZNW:EKV:HET
gebemoei	gebemoei	ZNW:EKV:HET
gebengel	gebengel	ZNW:EKV:HET
gebep	gebep	ZNW:EKV:HET
gebet	gebet	ZNW:EKV:HET
gebetuttel	gebetuttel	ZNW:EKV:HET
gebeuk	gebeuk	ZNW:EKV:HET
gebeul	gebeul	ZNW:EKV:HET
gebeun	gebeun	ZNW:EKV:HET
gebeur	gebeur	ZNW:EKV:HET
gebeuzel	gebeuzel	ZNW:EKV:HET
gebevrucht	gebevrucht	ZNW:EKV:HET
gebeweeg	gebeweeg	ZNW:EKV:HET
gebibber	gebibber	ZNW:EKV:HET
gebid	gebid	ZNW:EKV:HET
gebiecht	gebiecht	ZNW:EKV:HET
gebiep	gebiep	ZNW:EKV:HET
gebijt	gebijt	ZNW:EKV:HET
gebik	gebik	ZNW:EKV:HET
gebikkel	gebikkel	ZNW:EKV:HET
gebiljart	gebiljart	ZNW:EKV:HET
gebitch	gebitch	ZNW:EKV:HET
geblaak	geblaak	ZNW:EKV:HET
geblaar	geblaar	ZNW:EKV:HET
geblaat	geblaat	ZNW:EKV:HET
geblabla	geblabla	ZNW:EKV:HET
geblaf	geblaf	ZNW:EKV:HET
geblauwbek	geblauwbek	ZNW:EKV:HET
gebleek	gebleek	ZNW:EKV:HET
geblek	geblek	ZNW:EKV:HET
geblend	geblend	ZNW:EKV:HET
gebliep	gebliep	ZNW:EKV:HET
geblikker	geblikker	ZNW:EKV:HET
gebliksem	gebliksem	ZNW:EKV:HET
geblind	geblind	ZNW:EKV:HET
geblink	geblink	ZNW:EKV:HET
gebloed	gebloed	ZNW:EKV:HET
geblog	geblog	ZNW:EKV:HET
geblok	geblok	ZNW:EKV:HET
geblokkeer	geblokkeer	ZNW:EKV:HET
gebloos	gebloos	ZNW:EKV:HET
geblow	geblow	ZNW:EKV:HET
geblubber	geblubber	ZNW:EKV:HET
gebluf	gebluf	ZNW:EKV:HET
geblunder	geblunder	ZNW:EKV:HET
geblus	geblus	ZNW:EKV:HET
geblèr	geblèr	ZNW:EKV:HET
geblèt	geblèt	ZNW:EKV:HET
gebobbel	gebobbel	ZNW:EKV:HET
gebodyboard	gebodyboard	ZNW:EKV:HET
gebodybuild	gebodybuild	ZNW:EKV:HET
geboe	geboe	ZNW:EKV:HET
geboekhoud	geboekhoud	ZNW:EKV:HET
geboemel	geboemel	ZNW:EKV:HET
geboen	geboen	ZNW:EKV:HET
geboet	geboet	ZNW:EKV:HET
geboetseer	geboetseer	ZNW:EKV:HET
gebok	gebok	ZNW:EKV:HET
geboks	geboks	ZNW:EKV:HET
gebolder	gebolder	ZNW:EKV:HET
gebombardeer	gebombardeer	ZNW:EKV:HET
gebonk	gebonk	ZNW:EKV:HET
gebons	gebons	ZNW:EKV:HET
geboor	geboor	ZNW:EKV:HET
geboord	geboord	ZNW:EKV:HET
geboost	geboost	ZNW:EKV:HET
geboot	geboot	ZNW:EKV:HET
geborrel	geborrel	ZNW:EKV:HET
geborstel	geborstel	ZNW:EKV:HET
gebot	gebot	ZNW:EKV:HET
gebots	gebots	ZNW:EKV:HET
geboycot	geboycot	ZNW:EKV:HET
gebraak	gebraak	ZNW:EKV:HET
gebrabbel	gebrabbel	ZNW:EKV:HET
gebrainstorm	gebrainstorm	ZNW:EKV:HET
gebral	gebral	ZNW:EKV:HET
gebrand	gebrand	ZNW:EKV:HET
gebras	gebras	ZNW:EKV:HET
gebreek	gebreek	ZNW:EKV:HET
gebrei	gebrei	ZNW:EKV:HET
gebricoleer	gebricoleer	ZNW:EKV:HET
gebrief	gebrief	ZNW:EKV:HET
gebroddel	gebroddel	ZNW:EKV:HET
gebroed	gebroed	ZNW:EKV:HET
gebrok	gebrok	ZNW:EKV:HET
gebrokkel	gebrokkel	ZNW:EKV:HET
gebrom	gebrom	ZNW:EKV:HET
gebrouw	gebrouw	ZNW:EKV:HET
gebruin	gebruin	ZNW:EKV:HET
gebruis	gebruis	ZNW:EKV:HET
gebrul	gebrul	ZNW:EKV:HET
gebubbel	gebubbel	ZNW:EKV:HET
gebuffel	gebuffel	ZNW:EKV:HET
gebuig	gebuig	ZNW:EKV:HET
gebuitel	gebuitel	ZNW:EKV:HET
gebuk	gebuk	ZNW:EKV:HET
gebulder	gebulder	ZNW:EKV:HET
gebulk	gebulk	ZNW:EKV:HET
gebult	gebult	ZNW:EKV:HET
gebungel	gebungel	ZNW:EKV:HET
gebunker	gebunker	ZNW:EKV:HET
geburl	geburl	ZNW:EKV:HET
gebus	gebus	ZNW:EKV:HET
gebuts	gebuts	ZNW:EKV:HET
gebuurt	gebuurt	ZNW:EKV:HET
gebuut	gebuut	ZNW:EKV:HET
gecast	gecast	ZNW:EKV:HET
gecensureer	gecensureer	ZNW:EKV:HET
gecentreer	gecentreer	ZNW:EKV:HET
gecertificeer	gecertificeer	ZNW:EKV:HET
gechanteer	gechanteer	ZNW:EKV:HET
gechargeer	gechargeer	ZNW:EKV:HET
gechat	gechat	ZNW:EKV:HET
gecheck	gecheck	ZNW:EKV:HET
gechicaneer	gechicaneer	ZNW:EKV:HET
gecirkel	gecirkel	ZNW:EKV:HET
geciteer	geciteer	ZNW:EKV:HET
geclaim	geclaim	ZNW:EKV:HET
geclaxonneer	geclaxonneer	ZNW:EKV:HET
gecluster	gecluster	ZNW:EKV:HET
gecoach	gecoach	ZNW:EKV:HET
gecoat	gecoat	ZNW:EKV:HET
gecombineer	gecombineer	ZNW:EKV:HET
gecommandeer	gecommandeer	ZNW:EKV:HET
gecommentarieer	gecommentarieer	ZNW:EKV:HET
gecommuniceer	gecommuniceer	ZNW:EKV:HET
gecompliceer	gecompliceer	ZNW:EKV:HET
gecomplotteer	gecomplotteer	ZNW:EKV:HET
gecomputer	gecomputer	ZNW:EKV:HET
geconcentreer	geconcentreer	ZNW:EKV:HET
geconstrueer	geconstrueer	ZNW:EKV:HET
geconsumeer	geconsumeer	ZNW:EKV:HET
gecontroleer	gecontroleer	ZNW:EKV:HET
geconverseer	geconverseer	ZNW:EKV:HET
gecorrespondeer	gecorrespondeer	ZNW:EKV:HET
gecorrigeer	gecorrigeer	ZNW:EKV:HET
gecrash	gecrash	ZNW:EKV:HET
gecreëer	gecreëer	ZNW:EKV:HET
gecricket	gecricket	ZNW:EKV:HET
gecroon	gecroon	ZNW:EKV:HET
gecros	gecros	ZNW:EKV:HET
gecut	gecut	ZNW:EKV:HET
gedaal	gedaal	ZNW:EKV:HET
gedaas	gedaas	ZNW:EKV:HET
gedagvaard	gedagvaard	ZNW:EKV:HET
gedank	gedank	ZNW:EKV:HET
gedans	gedans	ZNW:EKV:HET
gedart	gedart	ZNW:EKV:HET
gedartel	gedartel	ZNW:EKV:HET
gedate	gedate	ZNW:EKV:HET
gedaver	gedaver	ZNW:EKV:HET
gedeal	gedeal	ZNW:EKV:HET
gedebatteer	gedebatteer	ZNW:EKV:HET
gedeclameer	gedeclameer	ZNW:EKV:HET
gedeclareer	gedeclareer	ZNW:EKV:HET
gedeel	gedeel	ZNW:EKV:HET
gedefinieer	gedefinieer	ZNW:EKV:HET
gedein	gedein	ZNW:EKV:HET
gedek	gedek	ZNW:EKV:HET
gedelete	gedelete	ZNW:EKV:HET
gedelf	gedelf	ZNW:EKV:HET
gedelibereer	gedelibereer	ZNW:EKV:HET
gedemoniseer	gedemoniseer	ZNW:EKV:HET
gedemonstreer	gedemonstreer	ZNW:EKV:HET
gedender	gedender	ZNW:EKV:HET
gedenk	gedenk	ZNW:EKV:HET
gedeponeer	gedeponeer	ZNW:EKV:HET
gedicteer	gedicteer	ZNW:EKV:HET
gedien	gedien	ZNW:EKV:HET
gedifferentieer	gedifferentieer	ZNW:EKV:HET
gedij	gedij	ZNW:EKV:HET
gedim	gedim	ZNW:EKV:HET
gedis	gedis	ZNW:EKV:HET
gediscrimineer	gediscrimineer	ZNW:EKV:HET
gediscussieer	gediscussieer	ZNW:EKV:HET
gedobbel	gedobbel	ZNW:EKV:HET
gedobber	gedobber	ZNW:EKV:HET
gedoedel	gedoedel	ZNW:EKV:HET
gedoel	gedoel	ZNW:EKV:HET
gedoelpunt	gedoelpunt	ZNW:EKV:HET
gedoezel	gedoezel	ZNW:EKV:HET
gedokter	gedokter	ZNW:EKV:HET
gedol	gedol	ZNW:EKV:HET
gedommel	gedommel	ZNW:EKV:HET
gedompel	gedompel	ZNW:EKV:HET
gedonder	gedonder	ZNW:EKV:HET
gedonderjaag	gedonderjaag	ZNW:EKV:HET
gedoof	gedoof	ZNW:EKV:HET
gedool	gedool	ZNW:EKV:HET
gedouw	gedouw	ZNW:EKV:HET
gedowngrade	gedowngrade	ZNW:EKV:HET
gedownload	gedownload	ZNW:EKV:HET
gedraaf	gedraaf	ZNW:EKV:HET
gedraag	gedraag	ZNW:EKV:HET
gedraal	gedraal	ZNW:EKV:HET
gedram	gedram	ZNW:EKV:HET
gedramatiseer	gedramatiseer	ZNW:EKV:HET
gedreig	gedreig	ZNW:EKV:HET
gedrein	gedrein	ZNW:EKV:HET
gedrens	gedrens	ZNW:EKV:HET
gedrentel	gedrentel	ZNW:EKV:HET
gedreun	gedreun	ZNW:EKV:HET
gedreutel	gedreutel	ZNW:EKV:HET
gedribbel	gedribbel	ZNW:EKV:HET
gedrift	gedrift	ZNW:EKV:HET
gedrijf	gedrijf	ZNW:EKV:HET
gedril	gedril	ZNW:EKV:HET
gedring	gedring	ZNW:EKV:HET
gedrink	gedrink	ZNW:EKV:HET
gedroedel	gedroedel	ZNW:EKV:HET
gedrop	gedrop	ZNW:EKV:HET
gedruil	gedruil	ZNW:EKV:HET
gedruip	gedruip	ZNW:EKV:HET
gedruis	gedruis	ZNW:EKV:HET
gedruk	gedruk	ZNW:EKV:HET
gedrum	gedrum	ZNW:EKV:HET
gedrup	gedrup	ZNW:EKV:HET
gedruppel	gedruppel	ZNW:EKV:HET
gedub	gedub	ZNW:EKV:HET
geduid	geduid	ZNW:EKV:HET
geduikel	geduikel	ZNW:EKV:HET
geduim	geduim	ZNW:EKV:HET
geduld	geduld	ZNW:EKV:HET
gedump	gedump	ZNW:EKV:HET
gedupeer	gedupeer	ZNW:EKV:HET
gedut	gedut	ZNW:EKV:HET
geduvel	geduvel	ZNW:EKV:HET
geduw	geduw	ZNW:EKV:HET
gedwaal	gedwaal	ZNW:EKV:HET
gedwarrel	gedwarrel	ZNW:EKV:HET
gedweep	gedweep	ZNW:EKV:HET
gedweil	gedweil	ZNW:EKV:HET
gedwing	gedwing	ZNW:EKV:HET
geemmer	geemmer	ZNW:EKV:HET
geepileer	geepileer	ZNW:EKV:HET
gefaal	gefaal	ZNW:EKV:HET
gefabriceer	gefabriceer	ZNW:EKV:HET
gefabuleer	gefabuleer	ZNW:EKV:HET
gefacelift	gefacelift	ZNW:EKV:HET
gefantaseer	gefantaseer	ZNW:EKV:HET
gefax	gefax	ZNW:EKV:HET
gefeliciteer	gefeliciteer	ZNW:EKV:HET
gefemel	gefemel	ZNW:EKV:HET
gefezel	gefezel	ZNW:EKV:HET
gefiedel	gefiedel	ZNW:EKV:HET
gefield	gefield	ZNW:EKV:HET
gefiets	gefiets	ZNW:EKV:HET
gefik	gefik	ZNW:EKV:HET
gefikfak	gefikfak	ZNW:EKV:HET
gefilm	gefilm	ZNW:EKV:HET
gefilosofeer	gefilosofeer	ZNW:EKV:HET
gefilter	gefilter	ZNW:EKV:HET
gefinancier	gefinancier	ZNW:EKV:HET
gefinetune	gefinetune	ZNW:EKV:HET
gefit	gefit	ZNW:EKV:HET
gefladder	gefladder	ZNW:EKV:HET
geflakker	geflakker	ZNW:EKV:HET
geflame	geflame	ZNW:EKV:HET
geflaneer	geflaneer	ZNW:EKV:HET
geflans	geflans	ZNW:EKV:HET
geflap	geflap	ZNW:EKV:HET
geflapper	geflapper	ZNW:EKV:HET
gefleem	gefleem	ZNW:EKV:HET
geflikflooi	geflikflooi	ZNW:EKV:HET
geflikker	geflikker	ZNW:EKV:HET
geflip	geflip	ZNW:EKV:HET
geflipper	geflipper	ZNW:EKV:HET
geflirt	geflirt	ZNW:EKV:HET
geflit	geflit	ZNW:EKV:HET
geflits	geflits	ZNW:EKV:HET
geflonker	geflonker	ZNW:EKV:HET
geflos	geflos	ZNW:EKV:HET
gefluim	gefluim	ZNW:EKV:HET
gefluister	gefluister	ZNW:EKV:HET
gefluit	gefluit	ZNW:EKV:HET
gefnuik	gefnuik	ZNW:EKV:HET
gefocus	gefocus	ZNW:EKV:HET
gefoefel	gefoefel	ZNW:EKV:HET
gefoeter	gefoeter	ZNW:EKV:HET
gefoezel	gefoezel	ZNW:EKV:HET
gefok	gefok	ZNW:EKV:HET
gefolter	gefolter	ZNW:EKV:HET
gefonkel	gefonkel	ZNW:EKV:HET
gefop	gefop	ZNW:EKV:HET
geforceer	geforceer	ZNW:EKV:HET
geformuleer	geformuleer	ZNW:EKV:HET
gefotografeer	gefotografeer	ZNW:EKV:HET
gefotoshop	gefotoshop	ZNW:EKV:HET
gefouilleer	gefouilleer	ZNW:EKV:HET
gefraudeer	gefraudeer	ZNW:EKV:HET
gefreak	gefreak	ZNW:EKV:HET
gefreelance	gefreelance	ZNW:EKV:HET
gefrees	gefrees	ZNW:EKV:HET
gefret	gefret	ZNW:EKV:HET
gefriemel	gefriemel	ZNW:EKV:HET
gefrituur	gefrituur	ZNW:EKV:HET
gefrommel	gefrommel	ZNW:EKV:HET
gefrons	gefrons	ZNW:EKV:HET
gefruit	gefruit	ZNW:EKV:HET
gefrummel	gefrummel	ZNW:EKV:HET
gefrunnik	gefrunnik	ZNW:EKV:HET
gefrustreer	gefrustreer	ZNW:EKV:HET
gefrutsel	gefrutsel	ZNW:EKV:HET
gefröbel	gefröbel	ZNW:EKV:HET
gefuck	gefuck	ZNW:EKV:HET
gefuif	gefuif	ZNW:EKV:HET
gefulmineer	gefulmineer	ZNW:EKV:HET
gefuseer	gefuseer	ZNW:EKV:HET
gefêteer	gefêteer	ZNW:EKV:HET
gegaap	gegaap	ZNW:EKV:HET
gegaar	gegaar	ZNW:EKV:HET
gegak	gegak	ZNW:EKV:HET
gegalm	gegalm	ZNW:EKV:HET
gegaloppeer	gegaloppeer	ZNW:EKV:HET
gegame	gegame	ZNW:EKV:HET
gegangbang	gegangbang	ZNW:EKV:HET
geganzenbord	geganzenbord	ZNW:EKV:HET
gegarandeer	gegarandeer	ZNW:EKV:HET
gegas	gegas	ZNW:EKV:HET
gegeef	gegeef	ZNW:EKV:HET
gegeeuw	gegeeuw	ZNW:EKV:HET
gegeil	gegeil	ZNW:EKV:HET
gegeit	gegeit	ZNW:EKV:HET
gegeneraliseer	gegeneraliseer	ZNW:EKV:HET
gegenereer	gegenereer	ZNW:EKV:HET
gegesel	gegesel	ZNW:EKV:HET
gegesticuleer	gegesticuleer	ZNW:EKV:HET
gegeur	gegeur	ZNW:EKV:HET
gegids	gegids	ZNW:EKV:HET
gegiebel	gegiebel	ZNW:EKV:HET
gegiechel	gegiechel	ZNW:EKV:HET
gegier	gegier	ZNW:EKV:HET
gegiet	gegiet	ZNW:EKV:HET
gegijzel	gegijzel	ZNW:EKV:HET
gegil	gegil	ZNW:EKV:HET
geginnegap	geginnegap	ZNW:EKV:HET
gegis	gegis	ZNW:EKV:HET
gegisp	gegisp	ZNW:EKV:HET
geglad	geglad	ZNW:EKV:HET
geglazuur	geglazuur	ZNW:EKV:HET
geglibber	geglibber	ZNW:EKV:HET
geglij	geglij	ZNW:EKV:HET
geglijd	geglijd	ZNW:EKV:HET
geglim	geglim	ZNW:EKV:HET
geglimlach	geglimlach	ZNW:EKV:HET
geglinster	geglinster	ZNW:EKV:HET
geglooi	geglooi	ZNW:EKV:HET
geglunder	geglunder	ZNW:EKV:HET
gegluur	gegluur	ZNW:EKV:HET
gegniffel	gegniffel	ZNW:EKV:HET
gegnuif	gegnuif	ZNW:EKV:HET
gegok	gegok	ZNW:EKV:HET
gegolf	gegolf	ZNW:EKV:HET
gegom	gegom	ZNW:EKV:HET
gegons	gegons	ZNW:EKV:HET
gegoochel	gegoochel	ZNW:EKV:HET
gegoogel	gegoogel	ZNW:EKV:HET
gegooi	gegooi	ZNW:EKV:HET
gegorgel	gegorgel	ZNW:EKV:HET
gegourmet	gegourmet	ZNW:EKV:HET
gegraaf	gegraaf	ZNW:EKV:HET
gegraai	gegraai	ZNW:EKV:HET
gegraas	gegraas	ZNW:EKV:HET
gegrabbel	gegrabbel	ZNW:EKV:HET
gegrap	gegrap	ZNW:EKV:HET
gegrasduin	gegrasduin	ZNW:EKV:HET
gegrauw	gegrauw	ZNW:EKV:HET
gegrief	gegrief	ZNW:EKV:HET
gegrien	gegrien	ZNW:EKV:HET
gegriezel	gegriezel	ZNW:EKV:HET
gegrif	gegrif	ZNW:EKV:HET
gegrijns	gegrijns	ZNW:EKV:HET
gegrijp	gegrijp	ZNW:EKV:HET
gegril	gegril	ZNW:EKV:HET
gegrind	gegrind	ZNW:EKV:HET
gegrinnik	gegrinnik	ZNW:EKV:HET
gegroei	gegroei	ZNW:EKV:HET
gegroet	gegroet	ZNW:EKV:HET
gegrol	gegrol	ZNW:EKV:HET
gegrom	gegrom	ZNW:EKV:HET
gegrommel	gegrommel	ZNW:EKV:HET
gegrondvest	gegrondvest	ZNW:EKV:HET
gegrut	gegrut	ZNW:EKV:HET
gegun	gegun	ZNW:EKV:HET
gehaak	gehaak	ZNW:EKV:HET
gehaal	gehaal	ZNW:EKV:HET
gehaast	gehaast	ZNW:EKV:HET
gehaat	gehaat	ZNW:EKV:HET
gehack	gehack	ZNW:EKV:HET
gehak	gehak	ZNW:EKV:HET
gehakkel	gehakkel	ZNW:EKV:HET
gehakketak	gehakketak	ZNW:EKV:HET
gehamer	gehamer	ZNW:EKV:HET
gehandhaaf	gehandhaaf	ZNW:EKV:HET
gehang	gehang	ZNW:EKV:HET
gehangglide	gehangglide	ZNW:EKV:HET
gehannes	gehannes	ZNW:EKV:HET
gehap	gehap	ZNW:EKV:HET
gehaper	gehaper	ZNW:EKV:HET
gehardloop	gehardloop	ZNW:EKV:HET
gehark	gehark	ZNW:EKV:HET
gehaspel	gehaspel	ZNW:EKV:HET
geheadbang	geheadbang	ZNW:EKV:HET
geheet	geheet	ZNW:EKV:HET
gehei	gehei	ZNW:EKV:HET
gehekel	gehekel	ZNW:EKV:HET
geheks	geheks	ZNW:EKV:HET
gehelp	gehelp	ZNW:EKV:HET
gehem	gehem	ZNW:EKV:HET
gehengel	gehengel	ZNW:EKV:HET
gehengst	gehengst	ZNW:EKV:HET
geherhaal	geherhaal	ZNW:EKV:HET
geherhuisvest	geherhuisvest	ZNW:EKV:HET
gehersenspoel	gehersenspoel	ZNW:EKV:HET
geheul	geheul	ZNW:EKV:HET
gehiel	gehiel	ZNW:EKV:HET
gehijg	gehijg	ZNW:EKV:HET
gehijs	gehijs	ZNW:EKV:HET
gehik	gehik	ZNW:EKV:HET
gehinder	gehinder	ZNW:EKV:HET
gehink	gehink	ZNW:EKV:HET
gehinkel	gehinkel	ZNW:EKV:HET
gehinnik	gehinnik	ZNW:EKV:HET
gehint	gehint	ZNW:EKV:HET
gehip	gehip	ZNW:EKV:HET
gehit	gehit	ZNW:EKV:HET
gehobbel	gehobbel	ZNW:EKV:HET
gehobby	gehobby	ZNW:EKV:HET
gehockey	gehockey	ZNW:EKV:HET
gehoed	gehoed	ZNW:EKV:HET
gehoer	gehoer	ZNW:EKV:HET
gehoereer	gehoereer	ZNW:EKV:HET
gehoest	gehoest	ZNW:EKV:HET
gehok	gehok	ZNW:EKV:HET
gehol	gehol	ZNW:EKV:HET
gehonk	gehonk	ZNW:EKV:HET
gehoon	gehoon	ZNW:EKV:HET
gehoop	gehoop	ZNW:EKV:HET
gehoor	gehoor	ZNW:EKV:HET
gehop	gehop	ZNW:EKV:HET
gehops	gehops	ZNW:EKV:HET
gehort	gehort	ZNW:EKV:HET
gehos	gehos	ZNW:EKV:HET
gehossel	gehossel	ZNW:EKV:HET
gehost	gehost	ZNW:EKV:HET
gehots	gehots	ZNW:EKV:HET
gehouw	gehouw	ZNW:EKV:HET
gehuichel	gehuichel	ZNW:EKV:HET
gehuil	gehuil	ZNW:EKV:HET
gehuilebalk	gehuilebalk	ZNW:EKV:HET
gehuishoud	gehuishoud	ZNW:EKV:HET
gehuisvest	gehuisvest	ZNW:EKV:HET
gehuiver	gehuiver	ZNW:EKV:HET
gehul	gehul	ZNW:EKV:HET
gehuldig	gehuldig	ZNW:EKV:HET
gehum	gehum	ZNW:EKV:HET
gehunker	gehunker	ZNW:EKV:HET
gehup	gehup	ZNW:EKV:HET
gehuppel	gehuppel	ZNW:EKV:HET
gehups	gehups	ZNW:EKV:HET
gehurk	gehurk	ZNW:EKV:HET
gehussel	gehussel	ZNW:EKV:HET
gehutsel	gehutsel	ZNW:EKV:HET
gehuur	gehuur	ZNW:EKV:HET
gehype	gehype	ZNW:EKV:HET
geijk	geijk	ZNW:EKV:HET
geijl	geijl	ZNW:EKV:HET
geijsbeer	geijsbeer	ZNW:EKV:HET
geijver	geijver	ZNW:EKV:HET
geimproviseer	geimproviseer	ZNW:EKV:HET
gejaag	gejaag	ZNW:EKV:HET
gejacht	gejacht	ZNW:EKV:HET
gejakker	gejakker	ZNW:EKV:HET
gejam	gejam	ZNW:EKV:HET
gejammer	gejammer	ZNW:EKV:HET
gejank	gejank	ZNW:EKV:HET
gejat	gejat	ZNW:EKV:HET
gejen	gejen	ZNW:EKV:HET
gejengel	gejengel	ZNW:EKV:HET
gejeremieer	gejeremieer	ZNW:EKV:HET
gejeuk	gejeuk	ZNW:EKV:HET
gejij	gejij	ZNW:EKV:HET
gejodel	gejodel	ZNW:EKV:HET
gejoel	gejoel	ZNW:EKV:HET
gejojo	gejojo	ZNW:EKV:HET
gejok	gejok	ZNW:EKV:HET
gejoker	gejoker	ZNW:EKV:HET
gejongleer	gejongleer	ZNW:EKV:HET
gejou	gejou	ZNW:EKV:HET
gejouw	gejouw	ZNW:EKV:HET
gejubel	gejubel	ZNW:EKV:HET
gejuich	gejuich	ZNW:EKV:HET
gejut	gejut	ZNW:EKV:HET
gekaard	gekaard	ZNW:EKV:HET
gekaart	gekaart	ZNW:EKV:HET
gekaats	gekaats	ZNW:EKV:HET
gekabbel	gekabbel	ZNW:EKV:HET
gekachel	gekachel	ZNW:EKV:HET
gekaffer	gekaffer	ZNW:EKV:HET
gekak	gekak	ZNW:EKV:HET
gekakel	gekakel	ZNW:EKV:HET
gekalk	gekalk	ZNW:EKV:HET
gekam	gekam	ZNW:EKV:HET
gekamp	gekamp	ZNW:EKV:HET
gekampeer	gekampeer	ZNW:EKV:HET
gekano	gekano	ZNW:EKV:HET
gekant	gekant	ZNW:EKV:HET
gekantel	gekantel	ZNW:EKV:HET
gekantrecht	gekantrecht	ZNW:EKV:HET
gekap	gekap	ZNW:EKV:HET
gekar	gekar	ZNW:EKV:HET
gekart	gekart	ZNW:EKV:HET
gekastijd	gekastijd	ZNW:EKV:HET
gekat	gekat	ZNW:EKV:HET
gekauw	gekauw	ZNW:EKV:HET
gekeel	gekeel	ZNW:EKV:HET
gekeer	gekeer	ZNW:EKV:HET
gekeet	gekeet	ZNW:EKV:HET
gekef	gekef	ZNW:EKV:HET
gekenmerk	gekenmerk	ZNW:EKV:HET
gekenschets	gekenschets	ZNW:EKV:HET
gekerk	gekerk	ZNW:EKV:HET
gekerm	gekerm	ZNW:EKV:HET
gekets	gekets	ZNW:EKV:HET
geketter	geketter	ZNW:EKV:HET
gekeur	gekeur	ZNW:EKV:HET
gekeutel	gekeutel	ZNW:EKV:HET
gekeuvel	gekeuvel	ZNW:EKV:HET
gekibbel	gekibbel	ZNW:EKV:HET
gekiel	gekiel	ZNW:EKV:HET
gekiep	gekiep	ZNW:EKV:HET
gekies	gekies	ZNW:EKV:HET
gekietel	gekietel	ZNW:EKV:HET
gekift	gekift	ZNW:EKV:HET
gekijf	gekijf	ZNW:EKV:HET
gekijk	gekijk	ZNW:EKV:HET
gekikker	gekikker	ZNW:EKV:HET
gekir	gekir	ZNW:EKV:HET
gekissebis	gekissebis	ZNW:EKV:HET
gekit	gekit	ZNW:EKV:HET
gekite	gekite	ZNW:EKV:HET
geklaag	geklaag	ZNW:EKV:HET
geklad	geklad	ZNW:EKV:HET
gekladder	gekladder	ZNW:EKV:HET
geklak	geklak	ZNW:EKV:HET
geklap	geklap	ZNW:EKV:HET
geklapper	geklapper	ZNW:EKV:HET
geklappertand	geklappertand	ZNW:EKV:HET
geklapwiek	geklapwiek	ZNW:EKV:HET
geklater	geklater	ZNW:EKV:HET
geklauter	geklauter	ZNW:EKV:HET
geklauw	geklauw	ZNW:EKV:HET
gekledder	gekledder	ZNW:EKV:HET
gekleed	gekleed	ZNW:EKV:HET
gekleef	gekleef	ZNW:EKV:HET
geklei	geklei	ZNW:EKV:HET
gekleineer	gekleineer	ZNW:EKV:HET
geklem	geklem	ZNW:EKV:HET
geklep	geklep	ZNW:EKV:HET
geklepel	geklepel	ZNW:EKV:HET
geklepper	geklepper	ZNW:EKV:HET
geklessebes	geklessebes	ZNW:EKV:HET
geklets	geklets	ZNW:EKV:HET
gekletter	gekletter	ZNW:EKV:HET
gekleum	gekleum	ZNW:EKV:HET
gekleun	gekleun	ZNW:EKV:HET
gekleur	gekleur	ZNW:EKV:HET
gekleuter	gekleuter	ZNW:EKV:HET
geklieder	geklieder	ZNW:EKV:HET
geklief	geklief	ZNW:EKV:HET
geklier	geklier	ZNW:EKV:HET
geklik	geklik	ZNW:EKV:HET
geklim	geklim	ZNW:EKV:HET
geklingel	geklingel	ZNW:EKV:HET
geklink	geklink	ZNW:EKV:HET
geklit	geklit	ZNW:EKV:HET
geklodder	geklodder	ZNW:EKV:HET
gekloet	gekloet	ZNW:EKV:HET
geklok	geklok	ZNW:EKV:HET
geklonter	geklonter	ZNW:EKV:HET
geklooi	geklooi	ZNW:EKV:HET
gekloot	gekloot	ZNW:EKV:HET
geklop	geklop	ZNW:EKV:HET
geklos	geklos	ZNW:EKV:HET
geklots	geklots	ZNW:EKV:HET
gekluif	gekluif	ZNW:EKV:HET
geklungel	geklungel	ZNW:EKV:HET
gekluns	gekluns	ZNW:EKV:HET
geklust	geklust	ZNW:EKV:HET
gekluts	gekluts	ZNW:EKV:HET
gekluun	gekluun	ZNW:EKV:HET
geknaag	geknaag	ZNW:EKV:HET
geknabbel	geknabbel	ZNW:EKV:HET
geknak	geknak	ZNW:EKV:HET
geknal	geknal	ZNW:EKV:HET
geknap	geknap	ZNW:EKV:HET
geknars	geknars	ZNW:EKV:HET
geknarsetand	geknarsetand	ZNW:EKV:HET
geknauw	geknauw	ZNW:EKV:HET
geknecht	geknecht	ZNW:EKV:HET
gekneed	gekneed	ZNW:EKV:HET
geknel	geknel	ZNW:EKV:HET
geknerp	geknerp	ZNW:EKV:HET
gekners	gekners	ZNW:EKV:HET
geknetter	geknetter	ZNW:EKV:HET
gekneus	gekneus	ZNW:EKV:HET
gekneuter	gekneuter	ZNW:EKV:HET
geknibbel	geknibbel	ZNW:EKV:HET
gekniel	gekniel	ZNW:EKV:HET
geknies	geknies	ZNW:EKV:HET
geknijp	geknijp	ZNW:EKV:HET
geknik	geknik	ZNW:EKV:HET
geknikkebol	geknikkebol	ZNW:EKV:HET
geknikker	geknikker	ZNW:EKV:HET
geknip	geknip	ZNW:EKV:HET
geknipper	geknipper	ZNW:EKV:HET
geknisper	geknisper	ZNW:EKV:HET
geknoei	geknoei	ZNW:EKV:HET
geknok	geknok	ZNW:EKV:HET
geknoop	geknoop	ZNW:EKV:HET
geknor	geknor	ZNW:EKV:HET
geknot	geknot	ZNW:EKV:HET
geknuffel	geknuffel	ZNW:EKV:HET
geknuppel	geknuppel	ZNW:EKV:HET
geknutsel	geknutsel	ZNW:EKV:HET
gekoek	gekoek	ZNW:EKV:HET
gekoekeloer	gekoekeloer	ZNW:EKV:HET
gekoers	gekoers	ZNW:EKV:HET
gekoester	gekoester	ZNW:EKV:HET
gekoeterwaal	gekoeterwaal	ZNW:EKV:HET
gekoketteer	gekoketteer	ZNW:EKV:HET
gekokhals	gekokhals	ZNW:EKV:HET
gekokkerel	gekokkerel	ZNW:EKV:HET
gekolf	gekolf	ZNW:EKV:HET
gekolk	gekolk	ZNW:EKV:HET
gekonfijt	gekonfijt	ZNW:EKV:HET
gekonkel	gekonkel	ZNW:EKV:HET
gekonkelfoes	gekonkelfoes	ZNW:EKV:HET
gekonterfeit	gekonterfeit	ZNW:EKV:HET
gekook	gekook	ZNW:EKV:HET
gekoos	gekoos	ZNW:EKV:HET
gekoot	gekoot	ZNW:EKV:HET
gekopieer	gekopieer	ZNW:EKV:HET
gekoppel	gekoppel	ZNW:EKV:HET
gekorst	gekorst	ZNW:EKV:HET
gekort	gekort	ZNW:EKV:HET
gekost	gekost	ZNW:EKV:HET
gekots	gekots	ZNW:EKV:HET
gekout	gekout	ZNW:EKV:HET
gekraai	gekraai	ZNW:EKV:HET
gekraak	gekraak	ZNW:EKV:HET
gekrab	gekrab	ZNW:EKV:HET
gekrabbel	gekrabbel	ZNW:EKV:HET
gekrakeel	gekrakeel	ZNW:EKV:HET
gekras	gekras	ZNW:EKV:HET
gekrassel	gekrassel	ZNW:EKV:HET
gekrenk	gekrenk	ZNW:EKV:HET
gekrent	gekrent	ZNW:EKV:HET
gekreuk	gekreuk	ZNW:EKV:HET
gekreun	gekreun	ZNW:EKV:HET
gekribbel	gekribbel	ZNW:EKV:HET
gekriebel	gekriebel	ZNW:EKV:HET
gekriek	gekriek	ZNW:EKV:HET
gekrijg	gekrijg	ZNW:EKV:HET
gekrijt	gekrijt	ZNW:EKV:HET
gekrik	gekrik	ZNW:EKV:HET
gekrioel	gekrioel	ZNW:EKV:HET
gekriskras	gekriskras	ZNW:EKV:HET
gekroel	gekroel	ZNW:EKV:HET
gekrom	gekrom	ZNW:EKV:HET
gekronkel	gekronkel	ZNW:EKV:HET
gekroon	gekroon	ZNW:EKV:HET
gekruid	gekruid	ZNW:EKV:HET
gekruimel	gekruimel	ZNW:EKV:HET
gekruip	gekruip	ZNW:EKV:HET
gekruis	gekruis	ZNW:EKV:HET
gekruk	gekruk	ZNW:EKV:HET
gekrul	gekrul	ZNW:EKV:HET
gekuch	gekuch	ZNW:EKV:HET
gekuier	gekuier	ZNW:EKV:HET
gekuip	gekuip	ZNW:EKV:HET
gekuis	gekuis	ZNW:EKV:HET
gekukel	gekukel	ZNW:EKV:HET
gekul	gekul	ZNW:EKV:HET
gekunstel	gekunstel	ZNW:EKV:HET
gekus	gekus	ZNW:EKV:HET
gekut	gekut	ZNW:EKV:HET
gekwaak	gekwaak	ZNW:EKV:HET
gekwak	gekwak	ZNW:EKV:HET
gekwakkel	gekwakkel	ZNW:EKV:HET
gekwal	gekwal	ZNW:EKV:HET
gekwansel	gekwansel	ZNW:EKV:HET
gekwartet	gekwartet	ZNW:EKV:HET
gekwast	gekwast	ZNW:EKV:HET
gekwat	gekwat	ZNW:EKV:HET
gekweek	gekweek	ZNW:EKV:HET
gekwek	gekwek	ZNW:EKV:HET
gekwel	gekwel	ZNW:EKV:HET
gekwets	gekwets	ZNW:EKV:HET
gekwetter	gekwetter	ZNW:EKV:HET
gekwijl	gekwijl	ZNW:EKV:HET
gekwijt	gekwijt	ZNW:EKV:HET
gekwinkeleer	gekwinkeleer	ZNW:EKV:HET
gekwispel	gekwispel	ZNW:EKV:HET
gelaad	gelaad	ZNW:EKV:HET
gelabel	gelabel	ZNW:EKV:HET
gelach	gelach	ZNW:EKV:HET
gelak	gelak	ZNW:EKV:HET
gelal	gelal	ZNW:EKV:HET
gelamenteer	gelamenteer	ZNW:EKV:HET
gelang	gelang	ZNW:EKV:HET
gelanterfant	gelanterfant	ZNW:EKV:HET
gelas	gelas	ZNW:EKV:HET
gelaster	gelaster	ZNW:EKV:HET
gelat	gelat	ZNW:EKV:HET
gelaveer	gelaveer	ZNW:EKV:HET
gelay-out	gelay-out	ZNW:EKV:HET
gelazer	gelazer	ZNW:EKV:HET
gelebber	gelebber	ZNW:EKV:HET
geledig	geledig	ZNW:EKV:HET
geleef	geleef	ZNW:EKV:HET
geleer	geleer	ZNW:EKV:HET
gelees	gelees	ZNW:EKV:HET
geleg	geleg	ZNW:EKV:HET
gelek	gelek	ZNW:EKV:HET
geleng	geleng	ZNW:EKV:HET
gelet	gelet	ZNW:EKV:HET
geleun	geleun	ZNW:EKV:HET
geleur	geleur	ZNW:EKV:HET
geleuter	geleuter	ZNW:EKV:HET
geliberaliseer	geliberaliseer	ZNW:EKV:HET
gelicht	gelicht	ZNW:EKV:HET
geliefhebber	geliefhebber	ZNW:EKV:HET
geliefkoos	geliefkoos	ZNW:EKV:HET
gelieg	gelieg	ZNW:EKV:HET
gelift	gelift	ZNW:EKV:HET
gelig	gelig	ZNW:EKV:HET
gelijk	gelijk	ZNW:EKV:HET
gelijm	gelijm	ZNW:EKV:HET
gelijn	gelijn	ZNW:EKV:HET
gelijst	gelijst	ZNW:EKV:HET
gelik	gelik	ZNW:EKV:HET
gelikkebaard	gelikkebaard	ZNW:EKV:HET
gelink	gelink	ZNW:EKV:HET
gelispel	gelispel	ZNW:EKV:HET
gelobby	gelobby	ZNW:EKV:HET
geloef	geloef	ZNW:EKV:HET
geloei	geloei	ZNW:EKV:HET
gelok	gelok	ZNW:EKV:HET
gelol	gelol	ZNW:EKV:HET
gelonk	gelonk	ZNW:EKV:HET
gelood	gelood	ZNW:EKV:HET
geloop	geloop	ZNW:EKV:HET
geloos	geloos	ZNW:EKV:HET
geloot	geloot	ZNW:EKV:HET
gelos	gelos	ZNW:EKV:HET
gelucht	gelucht	ZNW:EKV:HET
gelui	gelui	ZNW:EKV:HET
geluier	geluier	ZNW:EKV:HET
geluik	geluik	ZNW:EKV:HET
geluister	geluister	ZNW:EKV:HET
gelul	gelul	ZNW:EKV:HET
gelummel	gelummel	ZNW:EKV:HET
gelunch	gelunch	ZNW:EKV:HET
gelurk	gelurk	ZNW:EKV:HET
gelust	gelust	ZNW:EKV:HET
geluw	geluw	ZNW:EKV:HET
gemaai	gemaai	ZNW:EKV:HET
gemaak	gemaak	ZNW:EKV:HET
gemaan	gemaan	ZNW:EKV:HET
gemaar	gemaar	ZNW:EKV:HET
gemachtig	gemachtig	ZNW:EKV:HET
gemail	gemail	ZNW:EKV:HET
gemakel	gemakel	ZNW:EKV:HET
gemal	gemal	ZNW:EKV:HET
gemanage	gemanage	ZNW:EKV:HET
gemangel	gemangel	ZNW:EKV:HET
gemanipuleer	gemanipuleer	ZNW:EKV:HET
gemanoeuvreer	gemanoeuvreer	ZNW:EKV:HET
gemarchandeer	gemarchandeer	ZNW:EKV:HET
gemarcheer	gemarcheer	ZNW:EKV:HET
gemarket	gemarket	ZNW:EKV:HET
gemartel	gemartel	ZNW:EKV:HET
gemaskeer	gemaskeer	ZNW:EKV:HET
gemasseer	gemasseer	ZNW:EKV:HET
gemast	gemast	ZNW:EKV:HET
gemasturbeer	gemasturbeer	ZNW:EKV:HET
gemat	gemat	ZNW:EKV:HET
gematig	gematig	ZNW:EKV:HET
gemats	gemats	ZNW:EKV:HET
gemauw	gemauw	ZNW:EKV:HET
gemeander	gemeander	ZNW:EKV:HET
gemediteer	gemediteer	ZNW:EKV:HET
gemeesmuil	gemeesmuil	ZNW:EKV:HET
gemeester	gemeester	ZNW:EKV:HET
gemeet	gemeet	ZNW:EKV:HET
gemeier	gemeier	ZNW:EKV:HET
gemek	gemek	ZNW:EKV:HET
gemekker	gemekker	ZNW:EKV:HET
gemeld	gemeld	ZNW:EKV:HET
gemelk	gemelk	ZNW:EKV:HET
gemen	gemen	ZNW:EKV:HET
gemeneer	gemeneer	ZNW:EKV:HET
gemeng	gemeng	ZNW:EKV:HET
gemep	gemep	ZNW:EKV:HET
gemerk	gemerk	ZNW:EKV:HET
gemest	gemest	ZNW:EKV:HET
gemetsel	gemetsel	ZNW:EKV:HET
gemeuk	gemeuk	ZNW:EKV:HET
gemiauw	gemiauw	ZNW:EKV:HET
gemiep	gemiep	ZNW:EKV:HET
gemier	gemier	ZNW:EKV:HET
gemierenneuk	gemierenneuk	ZNW:EKV:HET
gemieter	gemieter	ZNW:EKV:HET
gemiezer	gemiezer	ZNW:EKV:HET
gemijmer	gemijmer	ZNW:EKV:HET
gemik	gemik	ZNW:EKV:HET
gemillimeter	gemillimeter	ZNW:EKV:HET
geminacht	geminacht	ZNW:EKV:HET
geminnekoos	geminnekoos	ZNW:EKV:HET
gemis	gemis	ZNW:EKV:HET
gemist	gemist	ZNW:EKV:HET
gemits	gemits	ZNW:EKV:HET
gemix	gemix	ZNW:EKV:HET
gemodder	gemodder	ZNW:EKV:HET
gemodelleer	gemodelleer	ZNW:EKV:HET
gemodereer	gemodereer	ZNW:EKV:HET
gemoeder	gemoeder	ZNW:EKV:HET
gemoei	gemoei	ZNW:EKV:HET
gemoffel	gemoffel	ZNW:EKV:HET
gemok	gemok	ZNW:EKV:HET
gemompel	gemompel	ZNW:EKV:HET
gemond	gemond	ZNW:EKV:HET
gemonkel	gemonkel	ZNW:EKV:HET
gemonteer	gemonteer	ZNW:EKV:HET
gemopper	gemopper	ZNW:EKV:HET
gemor	gemor	ZNW:EKV:HET
gemoraliseer	gemoraliseer	ZNW:EKV:HET
gemorrel	gemorrel	ZNW:EKV:HET
gemors	gemors	ZNW:EKV:HET
gemot	gemot	ZNW:EKV:HET
gemotiveer	gemotiveer	ZNW:EKV:HET
gemout	gemout	ZNW:EKV:HET
gemuggenzift	gemuggenzift	ZNW:EKV:HET
gemuit	gemuit	ZNW:EKV:HET
gemummel	gemummel	ZNW:EKV:HET
gemunt	gemunt	ZNW:EKV:HET
gemurmel	gemurmel	ZNW:EKV:HET
gemurmureer	gemurmureer	ZNW:EKV:HET
gemusiceer	gemusiceer	ZNW:EKV:HET
genaai	genaai	ZNW:EKV:HET
genaak	genaak	ZNW:EKV:HET
genar	genar	ZNW:EKV:HET
genas	genas	ZNW:EKV:HET
genat	genat	ZNW:EKV:HET
genegeer	genegeer	ZNW:EKV:HET
geneig	geneig	ZNW:EKV:HET
genet	genet	ZNW:EKV:HET
geneuk	geneuk	ZNW:EKV:HET
geneurie	geneurie	ZNW:EKV:HET
geneus	geneus	ZNW:EKV:HET
geneuzel	geneuzel	ZNW:EKV:HET
genevel	genevel	ZNW:EKV:HET
genies	genies	ZNW:EKV:HET
geniet	geniet	ZNW:EKV:HET
genietsnut	genietsnut	ZNW:EKV:HET
geniks	geniks	ZNW:EKV:HET
genivelleer	genivelleer	ZNW:EKV:HET
genoem	genoem	ZNW:EKV:HET
genomineer	genomineer	ZNW:EKV:HET
genood	genood	ZNW:EKV:HET
genoodzaak	genoodzaak	ZNW:EKV:HET
genuanceer	genuanceer	ZNW:EKV:HET
genut	genut	ZNW:EKV:HET
geoefen	geoefen	ZNW:EKV:HET
geoffer	geoffer	ZNW:EKV:HET
geoha	geoha	ZNW:EKV:HET
geolie	geolie	ZNW:EKV:HET
geonaneer	geonaneer	ZNW:EKV:HET
geoogst	geoogst	ZNW:EKV:HET
geoordeel	geoordeel	ZNW:EKV:HET
geopereer	geopereer	ZNW:EKV:HET
georakel	georakel	ZNW:EKV:HET
georden	georden	ZNW:EKV:HET
georeer	georeer	ZNW:EKV:HET
georganiseer	georganiseer	ZNW:EKV:HET
geout	geout	ZNW:EKV:HET
geouwehoer	geouwehoer	ZNW:EKV:HET
geouweneel	geouweneel	ZNW:EKV:HET
gepaai	gepaai	ZNW:EKV:HET
gepaar	gepaar	ZNW:EKV:HET
gepacht	gepacht	ZNW:EKV:HET
gepaf	gepaf	ZNW:EKV:HET
gepak	gepak	ZNW:EKV:HET
gepalaver	gepalaver	ZNW:EKV:HET
gepamper	gepamper	ZNW:EKV:HET
geparadeer	geparadeer	ZNW:EKV:HET
geparkeer	geparkeer	ZNW:EKV:HET
geparlesant	geparlesant	ZNW:EKV:HET
geparty	geparty	ZNW:EKV:HET
gepas	gepas	ZNW:EKV:HET
gepasseer	gepasseer	ZNW:EKV:HET
gepats	gepats	ZNW:EKV:HET
gepeddel	gepeddel	ZNW:EKV:HET
gepeeuw	gepeeuw	ZNW:EKV:HET
gepeil	gepeil	ZNW:EKV:HET
gepeins	gepeins	ZNW:EKV:HET
gepel	gepel	ZNW:EKV:HET
gepen	gepen	ZNW:EKV:HET
gependel	gependel	ZNW:EKV:HET
gepermanent	gepermanent	ZNW:EKV:HET
gepers	gepers	ZNW:EKV:HET
gepest	gepest	ZNW:EKV:HET
gepeur	gepeur	ZNW:EKV:HET
gepeuter	gepeuter	ZNW:EKV:HET
gepeuzel	gepeuzel	ZNW:EKV:HET
gepiek	gepiek	ZNW:EKV:HET
gepieker	gepieker	ZNW:EKV:HET
gepiel	gepiel	ZNW:EKV:HET
gepiemel	gepiemel	ZNW:EKV:HET
gepiep	gepiep	ZNW:EKV:HET
gepiepel	gepiepel	ZNW:EKV:HET
gepier	gepier	ZNW:EKV:HET
gepies	gepies	ZNW:EKV:HET
gepietepeuter	gepietepeuter	ZNW:EKV:HET
gepijp	gepijp	ZNW:EKV:HET
gepik	gepik	ZNW:EKV:HET
gepiket	gepiket	ZNW:EKV:HET
gepimpampet	gepimpampet	ZNW:EKV:HET
gepin	gepin	ZNW:EKV:HET
geping	geping	ZNW:EKV:HET
gepingel	gepingel	ZNW:EKV:HET
gepingpong	gepingpong	ZNW:EKV:HET
gepintelier	gepintelier	ZNW:EKV:HET
gepionier	gepionier	ZNW:EKV:HET
gepis	gepis	ZNW:EKV:HET
gepit	gepit	ZNW:EKV:HET
geplaag	geplaag	ZNW:EKV:HET
geplak	geplak	ZNW:EKV:HET
geplamuur	geplamuur	ZNW:EKV:HET
geplant	geplant	ZNW:EKV:HET
geplas	geplas	ZNW:EKV:HET
gepleeg	gepleeg	ZNW:EKV:HET
gepleit	gepleit	ZNW:EKV:HET
geplemp	geplemp	ZNW:EKV:HET
gepleng	gepleng	ZNW:EKV:HET
geplens	geplens	ZNW:EKV:HET
geplet	geplet	ZNW:EKV:HET
geplets	geplets	ZNW:EKV:HET
geploeter	geploeter	ZNW:EKV:HET
geplof	geplof	ZNW:EKV:HET
geplons	geplons	ZNW:EKV:HET
geplop	geplop	ZNW:EKV:HET
geplot	geplot	ZNW:EKV:HET
geplug	geplug	ZNW:EKV:HET
gepluis	gepluis	ZNW:EKV:HET
gepluk	gepluk	ZNW:EKV:HET
geplukhaar	geplukhaar	ZNW:EKV:HET
geplunder	geplunder	ZNW:EKV:HET
geplus	geplus	ZNW:EKV:HET
gepoch	gepoch	ZNW:EKV:HET
gepocheer	gepocheer	ZNW:EKV:HET
gepoedel	gepoedel	ZNW:EKV:HET
gepoep	gepoep	ZNW:EKV:HET
gepoer	gepoer	ZNW:EKV:HET
gepoets	gepoets	ZNW:EKV:HET
gepof	gepof	ZNW:EKV:HET
gepoker	gepoker	ZNW:EKV:HET
gepolariseer	gepolariseer	ZNW:EKV:HET
gepolder	gepolder	ZNW:EKV:HET
gepolemiseer	gepolemiseer	ZNW:EKV:HET
gepomp	gepomp	ZNW:EKV:HET
gepontificeer	gepontificeer	ZNW:EKV:HET
gepoog	gepoog	ZNW:EKV:HET
gepook	gepook	ZNW:EKV:HET
gepoot	gepoot	ZNW:EKV:HET
gepor	gepor	ZNW:EKV:HET
geport	geport	ZNW:EKV:HET
geposeer	geposeer	ZNW:EKV:HET
gepost	gepost	ZNW:EKV:HET
gepot	gepot	ZNW:EKV:HET
gepraal	gepraal	ZNW:EKV:HET
gepraat	gepraat	ZNW:EKV:HET
geprak	geprak	ZNW:EKV:HET
gepredik	gepredik	ZNW:EKV:HET
gepreek	gepreek	ZNW:EKV:HET
geprent	geprent	ZNW:EKV:HET
gepresenteer	gepresenteer	ZNW:EKV:HET
gepreutel	gepreutel	ZNW:EKV:HET
geprevel	geprevel	ZNW:EKV:HET
gepriegel	gepriegel	ZNW:EKV:HET
geprijs	geprijs	ZNW:EKV:HET
geprik	geprik	ZNW:EKV:HET
geprikkel	geprikkel	ZNW:EKV:HET
geprint	geprint	ZNW:EKV:HET
geprivatiseer	geprivatiseer	ZNW:EKV:HET
geprobeer	geprobeer	ZNW:EKV:HET
geprocedeer	geprocedeer	ZNW:EKV:HET
geproduceer	geproduceer	ZNW:EKV:HET
geproef	geproef	ZNW:EKV:HET
geproest	geproest	ZNW:EKV:HET
geprofiteer	geprofiteer	ZNW:EKV:HET
geprogrammeer	geprogrammeer	ZNW:EKV:HET
geprojecteer	geprojecteer	ZNW:EKV:HET
gepromoot	gepromoot	ZNW:EKV:HET
gepronk	gepronk	ZNW:EKV:HET
geproost	geproost	ZNW:EKV:HET
geprop	geprop	ZNW:EKV:HET
geprotesteer	geprotesteer	ZNW:EKV:HET
geprovoceer	geprovoceer	ZNW:EKV:HET
gepruil	gepruil	ZNW:EKV:HET
gepruim	gepruim	ZNW:EKV:HET
geprul	geprul	ZNW:EKV:HET
geprut	geprut	ZNW:EKV:HET
gepruts	gepruts	ZNW:EKV:HET
gepruttel	gepruttel	ZNW:EKV:HET
gepsychologiseer	gepsychologiseer	ZNW:EKV:HET
gepuber	gepuber	ZNW:EKV:HET
gepubliceer	gepubliceer	ZNW:EKV:HET
gepuf	gepuf	ZNW:EKV:HET
gepulk	gepulk	ZNW:EKV:HET
gepunnik	gepunnik	ZNW:EKV:HET
gepunter	gepunter	ZNW:EKV:HET
gepus	gepus	ZNW:EKV:HET
gepush	gepush	ZNW:EKV:HET
geput	geput	ZNW:EKV:HET
gepuzzel	gepuzzel	ZNW:EKV:HET
gequilt	gequilt	ZNW:EKV:HET
gequoot	gequoot	ZNW:EKV:HET
geraad	geraad	ZNW:EKV:HET
geraadpleeg	geraadpleeg	ZNW:EKV:HET
geraag	geraag	ZNW:EKV:HET
geraak	geraak	ZNW:EKV:HET
geraap	geraap	ZNW:EKV:HET
geraaskal	geraaskal	ZNW:EKV:HET
gerabat	gerabat	ZNW:EKV:HET
gerace	gerace	ZNW:EKV:HET
geraclet	geraclet	ZNW:EKV:HET
geradicaliseer	geradicaliseer	ZNW:EKV:HET
gerafel	gerafel	ZNW:EKV:HET
geraft	geraft	ZNW:EKV:HET
gerag	gerag	ZNW:EKV:HET
gerakel	gerakel	ZNW:EKV:HET
geraket	geraket	ZNW:EKV:HET
geram	geram	ZNW:EKV:HET
gerammel	gerammel	ZNW:EKV:HET
gerampetamp	gerampetamp	ZNW:EKV:HET
gerangeer	gerangeer	ZNW:EKV:HET
geransel	geransel	ZNW:EKV:HET
gerap	gerap	ZNW:EKV:HET
gerasp	gerasp	ZNW:EKV:HET
gerat	gerat	ZNW:EKV:HET
geratel	geratel	ZNW:EKV:HET
gerationaliseer	gerationaliseer	ZNW:EKV:HET
geraus	geraus	ZNW:EKV:HET
geravot	geravot	ZNW:EKV:HET
gereageer	gereageer	ZNW:EKV:HET
gerebbel	gerebbel	ZNW:EKV:HET
gereboot	gereboot	ZNW:EKV:HET
gerechercheer	gerechercheer	ZNW:EKV:HET
gerechtvaardig	gerechtvaardig	ZNW:EKV:HET
gereciteer	gereciteer	ZNW:EKV:HET
gerecycle	gerecycle	ZNW:EKV:HET
gerecycleer	gerecycleer	ZNW:EKV:HET
gered	gered	ZNW:EKV:HET
geredder	geredder	ZNW:EKV:HET
geredekavel	geredekavel	ZNW:EKV:HET
geredeneer	geredeneer	ZNW:EKV:HET
geredetwist	geredetwist	ZNW:EKV:HET
geredigeer	geredigeer	ZNW:EKV:HET
gereed	gereed	ZNW:EKV:HET
gerefereer	gerefereer	ZNW:EKV:HET
geregeer	geregeer	ZNW:EKV:HET
geregel	geregel	ZNW:EKV:HET
geregistreer	geregistreer	ZNW:EKV:HET
gereguleer	gereguleer	ZNW:EKV:HET
gerei	gerei	ZNW:EKV:HET
gereinig	gereinig	ZNW:EKV:HET
gereis	gereis	ZNW:EKV:HET
gerek	gerek	ZNW:EKV:HET
gereken	gereken	ZNW:EKV:HET
gerel	gerel	ZNW:EKV:HET
gerelateer	gerelateer	ZNW:EKV:HET
gerelativeer	gerelativeer	ZNW:EKV:HET
gerelax	gerelax	ZNW:EKV:HET
gerem	gerem	ZNW:EKV:HET
geren	geren	ZNW:EKV:HET
gerenoveer	gerenoveer	ZNW:EKV:HET
gerent	gerent	ZNW:EKV:HET
gereorganiseer	gereorganiseer	ZNW:EKV:HET
gerep	gerep	ZNW:EKV:HET
gerepareer	gerepareer	ZNW:EKV:HET
gerepeteer	gerepeteer	ZNW:EKV:HET
gereset	gereset	ZNW:EKV:HET
geresoneer	geresoneer	ZNW:EKV:HET
gerespecteer	gerespecteer	ZNW:EKV:HET
gerest	gerest	ZNW:EKV:HET
gereutel	gereutel	ZNW:EKV:HET
geriedel	geriedel	ZNW:EKV:HET
geriek	geriek	ZNW:EKV:HET
geriem	geriem	ZNW:EKV:HET
gerijd	gerijd	ZNW:EKV:HET
gerijf	gerijf	ZNW:EKV:HET
gerijm	gerijm	ZNW:EKV:HET
gerijmel	gerijmel	ZNW:EKV:HET
gerikketik	gerikketik	ZNW:EKV:HET
geril	geril	ZNW:EKV:HET
gering	gering	ZNW:EKV:HET
gerinkel	gerinkel	ZNW:EKV:HET
geris	geris	ZNW:EKV:HET
geritsel	geritsel	ZNW:EKV:HET
gerochel	gerochel	ZNW:EKV:HET
gerock	gerock	ZNW:EKV:HET
geroddel	geroddel	ZNW:EKV:HET
gerodel	gerodel	ZNW:EKV:HET
geroefel	geroefel	ZNW:EKV:HET
geroei	geroei	ZNW:EKV:HET
geroekoe	geroekoe	ZNW:EKV:HET
geroep	geroep	ZNW:EKV:HET
geroeptoeter	geroeptoeter	ZNW:EKV:HET
geroes	geroes	ZNW:EKV:HET
geroest	geroest	ZNW:EKV:HET
geroet	geroet	ZNW:EKV:HET
geroezemoes	geroezemoes	ZNW:EKV:HET
geroffel	geroffel	ZNW:EKV:HET
gerol	gerol	ZNW:EKV:HET
gerollebol	gerollebol	ZNW:EKV:HET
gerommel	gerommel	ZNW:EKV:HET
gerond	gerond	ZNW:EKV:HET
geronk	geronk	ZNW:EKV:HET
geronsel	geronsel	ZNW:EKV:HET
geroof	geroof	ZNW:EKV:HET
gerook	gerook	ZNW:EKV:HET
geroost	geroost	ZNW:EKV:HET
geroot	geroot	ZNW:EKV:HET
geros	geros	ZNW:EKV:HET
gerot	gerot	ZNW:EKV:HET
gerotzooi	gerotzooi	ZNW:EKV:HET
gerouleer	gerouleer	ZNW:EKV:HET
gerouw	gerouw	ZNW:EKV:HET
geruft	geruft	ZNW:EKV:HET
geruik	geruik	ZNW:EKV:HET
geruil	geruil	ZNW:EKV:HET
geruilebuit	geruilebuit	ZNW:EKV:HET
geruim	geruim	ZNW:EKV:HET
geruit	geruit	ZNW:EKV:HET
geruk	geruk	ZNW:EKV:HET
gerumoer	gerumoer	ZNW:EKV:HET
gerust	gerust	ZNW:EKV:HET
geruzie	geruzie	ZNW:EKV:HET
geruziemaak	geruziemaak	ZNW:EKV:HET
gesabbel	gesabbel	ZNW:EKV:HET
gesakker	gesakker	ZNW:EKV:HET
gesample	gesample	ZNW:EKV:HET
gesappel	gesappel	ZNW:EKV:HET
gesar	gesar	ZNW:EKV:HET
gescan	gescan	ZNW:EKV:HET
gescandeer	gescandeer	ZNW:EKV:HET
geschaad	geschaad	ZNW:EKV:HET
geschaaf	geschaaf	ZNW:EKV:HET
geschaak	geschaak	ZNW:EKV:HET
geschaats	geschaats	ZNW:EKV:HET
geschaft	geschaft	ZNW:EKV:HET
geschakel	geschakel	ZNW:EKV:HET
geschal	geschal	ZNW:EKV:HET
geschamper	geschamper	ZNW:EKV:HET
gescharrel	gescharrel	ZNW:EKV:HET
geschat	geschat	ZNW:EKV:HET
geschater	geschater	ZNW:EKV:HET
gescheer	gescheer	ZNW:EKV:HET
gescheid	gescheid	ZNW:EKV:HET
geschel	geschel	ZNW:EKV:HET
gescheld	gescheld	ZNW:EKV:HET
geschep	geschep	ZNW:EKV:HET
gescherts	gescherts	ZNW:EKV:HET
geschets	geschets	ZNW:EKV:HET
geschetter	geschetter	ZNW:EKV:HET
gescheur	gescheur	ZNW:EKV:HET
geschiet	geschiet	ZNW:EKV:HET
geschijt	geschijt	ZNW:EKV:HET
geschik	geschik	ZNW:EKV:HET
geschilder	geschilder	ZNW:EKV:HET
geschimp	geschimp	ZNW:EKV:HET
geschipper	geschipper	ZNW:EKV:HET
geschitter	geschitter	ZNW:EKV:HET
geschmier	geschmier	ZNW:EKV:HET
geschmink	geschmink	ZNW:EKV:HET
geschoffeer	geschoffeer	ZNW:EKV:HET
geschoffel	geschoffel	ZNW:EKV:HET
geschok	geschok	ZNW:EKV:HET
geschommel	geschommel	ZNW:EKV:HET
geschooi	geschooi	ZNW:EKV:HET
geschool	geschool	ZNW:EKV:HET
geschop	geschop	ZNW:EKV:HET
geschort	geschort	ZNW:EKV:HET
geschraap	geschraap	ZNW:EKV:HET
geschrans	geschrans	ZNW:EKV:HET
geschrap	geschrap	ZNW:EKV:HET
geschreeuw	geschreeuw	ZNW:EKV:HET
geschreew	geschreew	ZNW:EKV:HET
geschrei	geschrei	ZNW:EKV:HET
geschrijf	geschrijf	ZNW:EKV:HET
geschrob	geschrob	ZNW:EKV:HET
geschroef	geschroef	ZNW:EKV:HET
geschrok	geschrok	ZNW:EKV:HET
geschroot	geschroot	ZNW:EKV:HET
geschud	geschud	ZNW:EKV:HET
geschuif	geschuif	ZNW:EKV:HET
geschuifel	geschuifel	ZNW:EKV:HET
geschuil	geschuil	ZNW:EKV:HET
geschuim	geschuim	ZNW:EKV:HET
geschurk	geschurk	ZNW:EKV:HET
geschut	geschut	ZNW:EKV:HET
geschutter	geschutter	ZNW:EKV:HET
geschuur	geschuur	ZNW:EKV:HET
gescoor	gescoor	ZNW:EKV:HET
gescratch	gescratch	ZNW:EKV:HET
gescrol	gescrol	ZNW:EKV:HET
gescrub	gescrub	ZNW:EKV:HET
gesein	gesein	ZNW:EKV:HET
geseks	geseks	ZNW:EKV:HET
gesepareer	gesepareer	ZNW:EKV:HET
geshop	geshop	ZNW:EKV:HET
geshot	geshot	ZNW:EKV:HET
geshow	geshow	ZNW:EKV:HET
gesidder	gesidder	ZNW:EKV:HET
gesignaleer	gesignaleer	ZNW:EKV:HET
gesigneer	gesigneer	ZNW:EKV:HET
gesijpel	gesijpel	ZNW:EKV:HET
gesim	gesim	ZNW:EKV:HET
gesip	gesip	ZNW:EKV:HET
gesis	gesis	ZNW:EKV:HET
gesjacher	gesjacher	ZNW:EKV:HET
gesjans	gesjans	ZNW:EKV:HET
gesjees	gesjees	ZNW:EKV:HET
gesjilp	gesjilp	ZNW:EKV:HET
gesjirp	gesjirp	ZNW:EKV:HET
gesjoemel	gesjoemel	ZNW:EKV:HET
gesjok	gesjok	ZNW:EKV:HET
gesjor	gesjor	ZNW:EKV:HET
gesjot	gesjot	ZNW:EKV:HET
gesjouw	gesjouw	ZNW:EKV:HET
geskateboard	geskateboard	ZNW:EKV:HET
geski	geski	ZNW:EKV:HET
geslaap	geslaap	ZNW:EKV:HET
geslalom	geslalom	ZNW:EKV:HET
geslap	geslap	ZNW:EKV:HET
geslecht	geslecht	ZNW:EKV:HET
geslee	geslee	ZNW:EKV:HET
gesleed	gesleed	ZNW:EKV:HET
gesleep	gesleep	ZNW:EKV:HET
geslemp	geslemp	ZNW:EKV:HET
geslenter	geslenter	ZNW:EKV:HET
gesleur	gesleur	ZNW:EKV:HET
gesleutel	gesleutel	ZNW:EKV:HET
geslier	geslier	ZNW:EKV:HET
geslijm	geslijm	ZNW:EKV:HET
geslijp	geslijp	ZNW:EKV:HET
geslik	geslik	ZNW:EKV:HET
geslinger	geslinger	ZNW:EKV:HET
geslip	geslip	ZNW:EKV:HET
geslis	geslis	ZNW:EKV:HET
geslobber	geslobber	ZNW:EKV:HET
geslof	geslof	ZNW:EKV:HET
gesloop	gesloop	ZNW:EKV:HET
geslorp	geslorp	ZNW:EKV:HET
gesluikstort	gesluikstort	ZNW:EKV:HET
gesluimer	gesluimer	ZNW:EKV:HET
gesluip	gesluip	ZNW:EKV:HET
gesluis	gesluis	ZNW:EKV:HET
gesluit	gesluit	ZNW:EKV:HET
geslungel	geslungel	ZNW:EKV:HET
geslurp	geslurp	ZNW:EKV:HET
gesmaad	gesmaad	ZNW:EKV:HET
gesmacht	gesmacht	ZNW:EKV:HET
gesmak	gesmak	ZNW:EKV:HET
gesmart	gesmart	ZNW:EKV:HET
gesmash	gesmash	ZNW:EKV:HET
gesmeek	gesmeek	ZNW:EKV:HET
gesmet	gesmet	ZNW:EKV:HET
gesmiespel	gesmiespel	ZNW:EKV:HET
gesmijt	gesmijt	ZNW:EKV:HET
gesmikkel	gesmikkel	ZNW:EKV:HET
gesmoes	gesmoes	ZNW:EKV:HET
gesmoezel	gesmoezel	ZNW:EKV:HET
gesmokkel	gesmokkel	ZNW:EKV:HET
gesmul	gesmul	ZNW:EKV:HET
gesnaai	gesnaai	ZNW:EKV:HET
gesnack	gesnack	ZNW:EKV:HET
gesnak	gesnak	ZNW:EKV:HET
gesnap	gesnap	ZNW:EKV:HET
gesnater	gesnater	ZNW:EKV:HET
gesnauw	gesnauw	ZNW:EKV:HET
gesneer	gesneer	ZNW:EKV:HET
gesneeuw	gesneeuw	ZNW:EKV:HET
gesnerp	gesnerp	ZNW:EKV:HET
gesneukel	gesneukel	ZNW:EKV:HET
gesnif	gesnif	ZNW:EKV:HET
gesnik	gesnik	ZNW:EKV:HET
gesnipper	gesnipper	ZNW:EKV:HET
gesnoef	gesnoef	ZNW:EKV:HET
gesnoei	gesnoei	ZNW:EKV:HET
gesnoep	gesnoep	ZNW:EKV:HET
gesnoer	gesnoer	ZNW:EKV:HET
gesnor	gesnor	ZNW:EKV:HET
gesnork	gesnork	ZNW:EKV:HET
gesnorkel	gesnorkel	ZNW:EKV:HET
gesnotter	gesnotter	ZNW:EKV:HET
gesnowboard	gesnowboard	ZNW:EKV:HET
gesnuf	gesnuf	ZNW:EKV:HET
gesnuffel	gesnuffel	ZNW:EKV:HET
gesnuif	gesnuif	ZNW:EKV:HET
gesnuit	gesnuit	ZNW:EKV:HET
gesnurk	gesnurk	ZNW:EKV:HET
gesodemieter	gesodemieter	ZNW:EKV:HET
gesoebat	gesoebat	ZNW:EKV:HET
gesoes	gesoes	ZNW:EKV:HET
gesol	gesol	ZNW:EKV:HET
gesoldeer	gesoldeer	ZNW:EKV:HET
gesoleer	gesoleer	ZNW:EKV:HET
gesomber	gesomber	ZNW:EKV:HET
gesop	gesop	ZNW:EKV:HET
gesorteer	gesorteer	ZNW:EKV:HET
gesouffleer	gesouffleer	ZNW:EKV:HET
gespaad	gespaad	ZNW:EKV:HET
gespaan	gespaan	ZNW:EKV:HET
gespaar	gespaar	ZNW:EKV:HET
gespalk	gespalk	ZNW:EKV:HET
gespam	gespam	ZNW:EKV:HET
gespan	gespan	ZNW:EKV:HET
gespar	gespar	ZNW:EKV:HET
gespartel	gespartel	ZNW:EKV:HET
gespat	gespat	ZNW:EKV:HET
gespeculeer	gespeculeer	ZNW:EKV:HET
gespeech	gespeech	ZNW:EKV:HET
gespeel	gespeel	ZNW:EKV:HET
gespeld	gespeld	ZNW:EKV:HET
gespendeer	gespendeer	ZNW:EKV:HET
gespet	gespet	ZNW:EKV:HET
gespetter	gespetter	ZNW:EKV:HET
gespeur	gespeur	ZNW:EKV:HET
gespied	gespied	ZNW:EKV:HET
gespiegel	gespiegel	ZNW:EKV:HET
gespiek	gespiek	ZNW:EKV:HET
gespijbel	gespijbel	ZNW:EKV:HET
gespijker	gespijker	ZNW:EKV:HET
gespin	gespin	ZNW:EKV:HET
gespit	gespit	ZNW:EKV:HET
gesplijt	gesplijt	ZNW:EKV:HET
gesplit	gesplit	ZNW:EKV:HET
gesplits	gesplits	ZNW:EKV:HET
gespoed	gespoed	ZNW:EKV:HET
gespoel	gespoel	ZNW:EKV:HET
gesponsor	gesponsor	ZNW:EKV:HET
gespook	gespook	ZNW:EKV:HET
gesport	gesport	ZNW:EKV:HET
gespot	gespot	ZNW:EKV:HET
gespray	gespray	ZNW:EKV:HET
gespreek	gespreek	ZNW:EKV:HET
gespreid	gespreid	ZNW:EKV:HET
gespring	gespring	ZNW:EKV:HET
gesprint	gesprint	ZNW:EKV:HET
gesproei	gesproei	ZNW:EKV:HET
gesprokkel	gesprokkel	ZNW:EKV:HET
gespui	gespui	ZNW:EKV:HET
gespuit	gespuit	ZNW:EKV:HET
gespurt	gespurt	ZNW:EKV:HET
gesputter	gesputter	ZNW:EKV:HET
gespuug	gespuug	ZNW:EKV:HET
gespuw	gespuw	ZNW:EKV:HET
gestaak	gestaak	ZNW:EKV:HET
gestaar	gestaar	ZNW:EKV:HET
gestalk	gestalk	ZNW:EKV:HET
gestamel	gestamel	ZNW:EKV:HET
gestamp	gestamp	ZNW:EKV:HET
gestampvoet	gestampvoet	ZNW:EKV:HET
gestap	gestap	ZNW:EKV:HET
gestapel	gestapel	ZNW:EKV:HET
gestart	gestart	ZNW:EKV:HET
gestat	gestat	ZNW:EKV:HET
gestechel	gestechel	ZNW:EKV:HET
gesteek	gesteek	ZNW:EKV:HET
gesteel	gesteel	ZNW:EKV:HET
gesteggel	gesteggel	ZNW:EKV:HET
gesteiger	gesteiger	ZNW:EKV:HET
gestem	gestem	ZNW:EKV:HET
gestempel	gestempel	ZNW:EKV:HET
gesteun	gesteun	ZNW:EKV:HET
gesticht	gesticht	ZNW:EKV:HET
gestift	gestift	ZNW:EKV:HET
gestigmatiseer	gestigmatiseer	ZNW:EKV:HET
gestijg	gestijg	ZNW:EKV:HET
gestik	gestik	ZNW:EKV:HET
gestileer	gestileer	ZNW:EKV:HET
gestippel	gestippel	ZNW:EKV:HET
gestoef	gestoef	ZNW:EKV:HET
gestoei	gestoei	ZNW:EKV:HET
gestoemp	gestoemp	ZNW:EKV:HET
gestofzuig	gestofzuig	ZNW:EKV:HET
gestol	gestol	ZNW:EKV:HET
gestommel	gestommel	ZNW:EKV:HET
gestoof	gestoof	ZNW:EKV:HET
gestook	gestook	ZNW:EKV:HET
gestoom	gestoom	ZNW:EKV:HET
gestoot	gestoot	ZNW:EKV:HET
gestop	gestop	ZNW:EKV:HET
gestort	gestort	ZNW:EKV:HET
gestotter	gestotter	ZNW:EKV:HET
gestraal	gestraal	ZNW:EKV:HET
gestraf	gestraf	ZNW:EKV:HET
gestrand	gestrand	ZNW:EKV:HET
gestreef	gestreef	ZNW:EKV:HET
gestreel	gestreel	ZNW:EKV:HET
gestreep	gestreep	ZNW:EKV:HET
gestrek	gestrek	ZNW:EKV:HET
gestres	gestres	ZNW:EKV:HET
gestrijd	gestrijd	ZNW:EKV:HET
gestrijk	gestrijk	ZNW:EKV:HET
gestrompel	gestrompel	ZNW:EKV:HET
gestrooi	gestrooi	ZNW:EKV:HET
gestroom	gestroom	ZNW:EKV:HET
gestroop	gestroop	ZNW:EKV:HET
gestrubbel	gestrubbel	ZNW:EKV:HET
gestruikel	gestruikel	ZNW:EKV:HET
gestruin	gestruin	ZNW:EKV:HET
gestudeer	gestudeer	ZNW:EKV:HET
gestuif	gestuif	ZNW:EKV:HET
gestuit	gestuit	ZNW:EKV:HET
gestuiter	gestuiter	ZNW:EKV:HET
gestumper	gestumper	ZNW:EKV:HET
gestunt	gestunt	ZNW:EKV:HET
gestuntel	gestuntel	ZNW:EKV:HET
gestut	gestut	ZNW:EKV:HET
gesubsidieer	gesubsidieer	ZNW:EKV:HET
gesudder	gesudder	ZNW:EKV:HET
gesuf	gesuf	ZNW:EKV:HET
gesuggereer	gesuggereer	ZNW:EKV:HET
gesuis	gesuis	ZNW:EKV:HET
gesuizel	gesuizel	ZNW:EKV:HET
gesukkel	gesukkel	ZNW:EKV:HET
gesurf	gesurf	ZNW:EKV:HET
gesus	gesus	ZNW:EKV:HET
geswing	geswing	ZNW:EKV:HET
geswitch	geswitch	ZNW:EKV:HET
getaal	getaal	ZNW:EKV:HET
getakel	getakel	ZNW:EKV:HET
getalm	getalm	ZNW:EKV:HET
getamboer	getamboer	ZNW:EKV:HET
getand	getand	ZNW:EKV:HET
getap	getap	ZNW:EKV:HET
getart	getart	ZNW:EKV:HET
getast	getast	ZNW:EKV:HET
getater	getater	ZNW:EKV:HET
geteem	geteem	ZNW:EKV:HET
geteister	geteister	ZNW:EKV:HET
geteken	geteken	ZNW:EKV:HET
getel	getel	ZNW:EKV:HET
getelefoneer	getelefoneer	ZNW:EKV:HET
getennis	getennis	ZNW:EKV:HET
geterg	geterg	ZNW:EKV:HET
geterroriseer	geterroriseer	ZNW:EKV:HET
getest	getest	ZNW:EKV:HET
getet	getet	ZNW:EKV:HET
getetter	getetter	ZNW:EKV:HET
geteut	geteut	ZNW:EKV:HET
getheoretiseer	getheoretiseer	ZNW:EKV:HET
getier	getier	ZNW:EKV:HET
getik	getik	ZNW:EKV:HET
getiktak	getiktak	ZNW:EKV:HET
getil	getil	ZNW:EKV:HET
getimmer	getimmer	ZNW:EKV:HET
getingel	getingel	ZNW:EKV:HET
getink	getink	ZNW:EKV:HET
getinkel	getinkel	ZNW:EKV:HET
getint	getint	ZNW:EKV:HET
getintel	getintel	ZNW:EKV:HET
getippel	getippel	ZNW:EKV:HET
getjilp	getjilp	ZNW:EKV:HET
getjirp	getjirp	ZNW:EKV:HET
getoast	getoast	ZNW:EKV:HET
getob	getob	ZNW:EKV:HET
getocht	getocht	ZNW:EKV:HET
getoet	getoet	ZNW:EKV:HET
getoeter	getoeter	ZNW:EKV:HET
getoets	getoets	ZNW:EKV:HET
getok	getok	ZNW:EKV:HET
getokkel	getokkel	ZNW:EKV:HET
getol	getol	ZNW:EKV:HET
getolereer	getolereer	ZNW:EKV:HET
getolk	getolk	ZNW:EKV:HET
getoon	getoon	ZNW:EKV:HET
getoonzet	getoonzet	ZNW:EKV:HET
getoost	getoost	ZNW:EKV:HET
getorn	getorn	ZNW:EKV:HET
getortel	getortel	ZNW:EKV:HET
getos	getos	ZNW:EKV:HET
getover	getover	ZNW:EKV:HET
getraan	getraan	ZNW:EKV:HET
getracht	getracht	ZNW:EKV:HET
getrain	getrain	ZNW:EKV:HET
getraineer	getraineer	ZNW:EKV:HET
getrap	getrap	ZNW:EKV:HET
getrappel	getrappel	ZNW:EKV:HET
getreiter	getreiter	ZNW:EKV:HET
getrek	getrek	ZNW:EKV:HET
getreur	getreur	ZNW:EKV:HET
getreuzel	getreuzel	ZNW:EKV:HET
getril	getril	ZNW:EKV:HET
getrim	getrim	ZNW:EKV:HET
getrip	getrip	ZNW:EKV:HET
getrippel	getrippel	ZNW:EKV:HET
getroetel	getroetel	ZNW:EKV:HET
getrol	getrol	ZNW:EKV:HET
getrom	getrom	ZNW:EKV:HET
getrommel	getrommel	ZNW:EKV:HET
getromp	getromp	ZNW:EKV:HET
getrompet	getrompet	ZNW:EKV:HET
getrompetter	getrompetter	ZNW:EKV:HET
getroost	getroost	ZNW:EKV:HET
getrouw	getrouw	ZNW:EKV:HET
getsjilp	getsjilp	ZNW:EKV:HET
getsjirp	getsjirp	ZNW:EKV:HET
getuf	getuf	ZNW:EKV:HET
getuig	getuig	ZNW:EKV:HET
getuimel	getuimel	ZNW:EKV:HET
getuit	getuit	ZNW:EKV:HET
geturf	geturf	ZNW:EKV:HET
geturn	geturn	ZNW:EKV:HET
getut	getut	ZNW:EKV:HET
getutoyeer	getutoyeer	ZNW:EKV:HET
getweak	getweak	ZNW:EKV:HET
getweet	getweet	ZNW:EKV:HET
getwijfel	getwijfel	ZNW:EKV:HET
getwinkel	getwinkel	ZNW:EKV:HET
getwist	getwist	ZNW:EKV:HET
getwitter	getwitter	ZNW:EKV:HET
getyp	getyp	ZNW:EKV:HET
getypecast	getypecast	ZNW:EKV:HET
getypeer	getypeer	ZNW:EKV:HET
geuit	geuit	ZNW:EKV:HET
gevaag	gevaag	ZNW:EKV:HET
gevader	gevader	ZNW:EKV:HET
gevang	gevang	ZNW:EKV:HET
gevast	gevast	ZNW:EKV:HET
gevat	gevat	ZNW:EKV:HET
geveeg	geveeg	ZNW:EKV:HET
geveel	geveel	ZNW:EKV:HET
geveer	geveer	ZNW:EKV:HET
geveest	geveest	ZNW:EKV:HET
geveil	geveil	ZNW:EKV:HET
geveins	geveins	ZNW:EKV:HET
gevent	gevent	ZNW:EKV:HET
geventileer	geventileer	ZNW:EKV:HET
geverf	geverf	ZNW:EKV:HET
gevest	gevest	ZNW:EKV:HET
gevestig	gevestig	ZNW:EKV:HET
gevet	gevet	ZNW:EKV:HET
gevibreer	gevibreer	ZNW:EKV:HET
gevier	gevier	ZNW:EKV:HET
gevijl	gevijl	ZNW:EKV:HET
gevijs	gevijs	ZNW:EKV:HET
gevil	gevil	ZNW:EKV:HET
gevilt	gevilt	ZNW:EKV:HET
gevinger	gevinger	ZNW:EKV:HET
gevis	gevis	ZNW:EKV:HET
gevit	gevit	ZNW:EKV:HET
gevlag	gevlag	ZNW:EKV:HET
gevlam	gevlam	ZNW:EKV:HET
gevlecht	gevlecht	ZNW:EKV:HET
gevlei	gevlei	ZNW:EKV:HET
gevlet	gevlet	ZNW:EKV:HET
gevlieg	gevlieg	ZNW:EKV:HET
gevlij	gevlij	ZNW:EKV:HET
gevlinder	gevlinder	ZNW:EKV:HET
gevloek	gevloek	ZNW:EKV:HET
gevlooi	gevlooi	ZNW:EKV:HET
gevlot	gevlot	ZNW:EKV:HET
gevlucht	gevlucht	ZNW:EKV:HET
gevlugger	gevlugger	ZNW:EKV:HET
gevocht	gevocht	ZNW:EKV:HET
gevod	gevod	ZNW:EKV:HET
gevoed	gevoed	ZNW:EKV:HET
gevoeg	gevoeg	ZNW:EKV:HET
gevoer	gevoer	ZNW:EKV:HET
gevoetbal	gevoetbal	ZNW:EKV:HET
gevogel	gevogel	ZNW:EKV:HET
gevonk	gevonk	ZNW:EKV:HET
gevoos	gevoos	ZNW:EKV:HET
gevorder	gevorder	ZNW:EKV:HET
gevouw	gevouw	ZNW:EKV:HET
gevraag	gevraag	ZNW:EKV:HET
gevreet	gevreet	ZNW:EKV:HET
gevries	gevries	ZNW:EKV:HET
gevrij	gevrij	ZNW:EKV:HET
gevut	gevut	ZNW:EKV:HET
gevuur	gevuur	ZNW:EKV:HET
gewaag	gewaag	ZNW:EKV:HET
gewaai	gewaai	ZNW:EKV:HET
gewaarborg	gewaarborg	ZNW:EKV:HET
gewacht	gewacht	ZNW:EKV:HET
gewaggel	gewaggel	ZNW:EKV:HET
gewalg	gewalg	ZNW:EKV:HET
gewalm	gewalm	ZNW:EKV:HET
gewals	gewals	ZNW:EKV:HET
gewandel	gewandel	ZNW:EKV:HET
gewankel	gewankel	ZNW:EKV:HET
gewantrouw	gewantrouw	ZNW:EKV:HET
gewapper	gewapper	ZNW:EKV:HET
gewatertand	gewatertand	ZNW:EKV:HET
gewauwel	gewauwel	ZNW:EKV:HET
gewax	gewax	ZNW:EKV:HET
gewed	gewed	ZNW:EKV:HET
gewedijver	gewedijver	ZNW:EKV:HET
geweef	geweef	ZNW:EKV:HET
geweeg	geweeg	ZNW:EKV:HET
geweekend	geweekend	ZNW:EKV:HET
geweeklaag	geweeklaag	ZNW:EKV:HET
geween	geween	ZNW:EKV:HET
geweid	geweid	ZNW:EKV:HET
geweifel	geweifel	ZNW:EKV:HET
geweiger	geweiger	ZNW:EKV:HET
gewemel	gewemel	ZNW:EKV:HET
gewen	gewen	ZNW:EKV:HET
gewens	gewens	ZNW:EKV:HET
gewentel	gewentel	ZNW:EKV:HET
gewerf	gewerf	ZNW:EKV:HET
gewerp	gewerp	ZNW:EKV:HET
gewet	gewet	ZNW:EKV:HET
gewiebel	gewiebel	ZNW:EKV:HET
gewied	gewied	ZNW:EKV:HET
gewieg	gewieg	ZNW:EKV:HET
gewiegel	gewiegel	ZNW:EKV:HET
gewiek	gewiek	ZNW:EKV:HET
gewiel	gewiel	ZNW:EKV:HET
gewijs	gewijs	ZNW:EKV:HET
gewijzig	gewijzig	ZNW:EKV:HET
gewik	gewik	ZNW:EKV:HET
gewikkel	gewikkel	ZNW:EKV:HET
gewil	gewil	ZNW:EKV:HET
gewillig	gewillig	ZNW:EKV:HET
gewin	gewin	ZNW:EKV:HET
gewind	gewind	ZNW:EKV:HET
gewinkel	gewinkel	ZNW:EKV:HET
gewip	gewip	ZNW:EKV:HET
gewissel	gewissel	ZNW:EKV:HET
gewit	gewit	ZNW:EKV:HET
gewoed	gewoed	ZNW:EKV:HET
gewoeker	gewoeker	ZNW:EKV:HET
gewoel	gewoel	ZNW:EKV:HET
gewoon	gewoon	ZNW:EKV:HET
geword	geword	ZNW:EKV:HET
geworstel	geworstel	ZNW:EKV:HET
gewrijf	gewrijf	ZNW:EKV:HET
gewrik	gewrik	ZNW:EKV:HET
gewring	gewring	ZNW:EKV:HET
gewroet	gewroet	ZNW:EKV:HET
gewuif	gewuif	ZNW:EKV:HET
gewurg	gewurg	ZNW:EKV:HET
gewurm	gewurm	ZNW:EKV:HET
gezaag	gezaag	ZNW:EKV:HET
gezaai	gezaai	ZNW:EKV:HET
gezak	gezak	ZNW:EKV:HET
gezalf	gezalf	ZNW:EKV:HET
gezand	gezand	ZNW:EKV:HET
gezanik	gezanik	ZNW:EKV:HET
gezap	gezap	ZNW:EKV:HET
gezeef	gezeef	ZNW:EKV:HET
gezeem	gezeem	ZNW:EKV:HET
gezegen	gezegen	ZNW:EKV:HET
gezeik	gezeik	ZNW:EKV:HET
gezeil	gezeil	ZNW:EKV:HET
gezemel	gezemel	ZNW:EKV:HET
gezet	gezet	ZNW:EKV:HET
gezeul	gezeul	ZNW:EKV:HET
gezeur	gezeur	ZNW:EKV:HET
gezever	gezever	ZNW:EKV:HET
gezied	gezied	ZNW:EKV:HET
geziek	geziek	ZNW:EKV:HET
gezift	gezift	ZNW:EKV:HET
gezigzag	gezigzag	ZNW:EKV:HET
gezinder	gezinder	ZNW:EKV:HET
gezing	gezing	ZNW:EKV:HET
gezit	gezit	ZNW:EKV:HET
gezoef	gezoef	ZNW:EKV:HET
gezoek	gezoek	ZNW:EKV:HET
gezoem	gezoem	ZNW:EKV:HET
gezoen	gezoen	ZNW:EKV:HET
gezoet	gezoet	ZNW:EKV:HET
gezomer	gezomer	ZNW:EKV:HET
gezon	gezon	ZNW:EKV:HET
gezondig	gezondig	ZNW:EKV:HET
gezonnebaad	gezonnebaad	ZNW:EKV:HET
gezoom	gezoom	ZNW:EKV:HET
gezorg	gezorg	ZNW:EKV:HET
gezucht	gezucht	ZNW:EKV:HET
gezuig	gezuig	ZNW:EKV:HET
gezuip	gezuip	ZNW:EKV:HET
gezuur	gezuur	ZNW:EKV:HET
gezwaai	gezwaai	ZNW:EKV:HET
gezwabber	gezwabber	ZNW:EKV:HET
gezwalk	gezwalk	ZNW:EKV:HET
gezwalp	gezwalp	ZNW:EKV:HET
gezwaluwstaart	gezwaluwstaart	ZNW:EKV:HET
gezwam	gezwam	ZNW:EKV:HET
gezwans	gezwans	ZNW:EKV:HET
gezwart	gezwart	ZNW:EKV:HET
gezwartepiet	gezwartepiet	ZNW:EKV:HET
gezwatel	gezwatel	ZNW:EKV:HET
gezweed	gezweed	ZNW:EKV:HET
gezweef	gezweef	ZNW:EKV:HET
gezweep	gezweep	ZNW:EKV:HET
gezweer	gezweer	ZNW:EKV:HET
gezweet	gezweet	ZNW:EKV:HET
gezwelg	gezwelg	ZNW:EKV:HET
gezwem	gezwem	ZNW:EKV:HET
gezwendel	gezwendel	ZNW:EKV:HET
gezwengel	gezwengel	ZNW:EKV:HET
gezwenk	gezwenk	ZNW:EKV:HET
gezwerf	gezwerf	ZNW:EKV:HET
gezwerm	gezwerm	ZNW:EKV:HET
gezwets	gezwets	ZNW:EKV:HET
gezwicht	gezwicht	ZNW:EKV:HET
gezwiep	gezwiep	ZNW:EKV:HET
gezwier	gezwier	ZNW:EKV:HET
gezwijg	gezwijg	ZNW:EKV:HET
gezwijmel	gezwijmel	ZNW:EKV:HET
gezwijn	gezwijn	ZNW:EKV:HET
gezwoeg	gezwoeg	ZNW:EKV:HET
geëcho	geëcho	ZNW:EKV:HET
geënt	geënt	ZNW:EKV:HET
geëxperimenteer	geëxperimenteer	ZNW:EKV:HET
geïdealiseer	geïdealiseer	ZNW:EKV:HET
geïmproviseer	geïmproviseer	ZNW:EKV:HET
geïnkt	geïnkt	ZNW:EKV:HET
geïntegreer	geïntegreer	ZNW:EKV:HET
geïnteresseer	geïnteresseer	ZNW:EKV:HET
geïnternet	geïnternet	ZNW:EKV:HET
geïnterpreteer	geïnterpreteer	ZNW:EKV:HET
geïnterview	geïnterview	ZNW:EKV:HET
geïntimideer	geïntimideer	ZNW:EKV:HET
geïntrigeer	geïntrigeer	ZNW:EKV:HET
hem	hem	PVW
hondengejank	hondengejank	ZNW:EKV:HET
jammergeschrei	jammergeschrei	ZNW:EKV:HET
klaaggeschrei	klaaggeschrei	ZNW:EKV:HET
losgepraat	losgepraat	ZNW:EKV:HET
melde	melde	ZNW:EKV:DE_
oorlogsgetuig	oorlogsgetuig	ZNW:EKV:HET
overgeplant	overgeplant	ZNW:EKV:HET
paardengetuig	paardengetuig	ZNW:EKV:HET
personagekaart	personagekaart	ZNW:EKV:HET
toegespeld	toegespeld	ZNW:EKV:HET
uitgebijt	uitgebijt	ZNW:EKV:HET
uitgeplant	uitgeplant	ZNW:EKV:HET
uitgerond	uitgerond	ZNW:EKV:HET
uitgezweet	uitgezweet	ZNW:EKV:HET
vastgepraat	vastgepraat	ZNW:EKV:HET
vogelgeschrei	vogelgeschrei	ZNW:EKV:HET
voorgepraat	voorgepraat	ZNW:EKV:HET
voortgeplant	voortgeplant	ZNW:EKV:HET
vreugdegeschrei	vreugdegeschrei	ZNW:EKV:HET
wakkergeschud	wakkergeschud	ZNW:EKV:HET
wolvengejank	wolvengejank	ZNW:EKV:HET
Bangkok	Bangkok	ENM:LOC:PTS
Hardinxveld	Hardinxveld	ENM:LOC:PTS
Spa	Spa	ENM:LOC:PTS
amfitheatersgewijs	amfitheatersgewijs	BNW:STL:ONV
baksgewijs	baksgewijs	BNW:STL:ONV
cirkelgewijs	cirkelgewijs	BNW:STL:ONV
etagegewijs	etagegewijs	BNW:STL:ONV
etappegewijs	etappegewijs	BNW:STL:ONV
karavaansgewijs	karavaansgewijs	BNW:STL:ONV
kolomsgewijs	kolomsgewijs	BNW:STL:ONV
kwartaalsgewijs	kwartaalsgewijs	BNW:STL:ONV
lepelsgewijs	lepelsgewijs	BNW:STL:ONV
massagewijs	massagewijs	BNW:STL:ONV
ondernemersgewijs	ondernemersgewijs	BNW:STL:ONV
percentagewijs	percentagewijs	BNW:STL:ONV
processiegewijs	processiegewijs	BNW:STL:ONV
ruitsgewijs	ruitsgewijs	BNW:STL:ONV
speelsgewijs	speelsgewijs	BNW:STL:ONV
staaksgewijs	staaksgewijs	BNW:STL:ONV
steelsgewijs	steelsgewijs	BNW:STL:ONV
terrasgewijs	terrasgewijs	BNW:STL:ONV
troepsgewijs	troepsgewijs	BNW:STL:ONV
Aken	Aken	ENM:LOC:PTS
Duinoord	Duinoord	ENM:LOC:PTS
Madrid	Madrid	ENM:LOC:PTS
Sofia	Sofia	ENM:LOC:PTS
Zweden	Zweden	ENM:LOC:LND
Zwijnaarde	Zwijnaarde	ENM:LOC:PTS
Zürich	Zürich	ENM:LOC:PTS
maar	maar	BYW
maar	maar	VGW
zoveel	zoveel	BYW
zoveel	zoveel	VNW
Asper	Asper	ENM:LOC:PTS
Assenede	Assenede	ENM:LOC:PTS
Athene	Athene	ENM:LOC:PTS
Avelgem	Avelgem	ENM:LOC:PTS
Batavia	Batavia	ENM:LOC:PTS
Brus	Brus	ENM:LOC:PTS
Charlois	Charlois	ENM:LOC:PTS
Dachau	Dachau	ENM:LOC:PTS
Edelare	Edelare	ENM:LOC:PTS
Hollandia	Hollandia	ENM:LOC:PTS
Kerk	Kerk	ENM:LOC:PTS
Leest	Leest	ENM:LOC:PTS
Lissabon	Lissabon	ENM:LOC:PTS
Moll	Moll	ENM:LOC:PTS
Oudshoorn	Oudshoorn	ENM:LOC:PTS
Peking	Peking	ENM:LOC:PTS
Poederlee	Poederlee	ENM:LOC:PTS
Poona	Poona	ENM:LOC:PTS
Praag	Praag	ENM:LOC:PTS
Schelderode	Schelderode	ENM:LOC:PTS
Sint-Joris	Sint-Joris	ENM:LOC:PTS
Texel	Texel	ENM:LOC:PTS
Vroenhoven	Vroenhoven	ENM:LOC:PTS
Wesel	Wesel	ENM:LOC:PTS
Xantippe	Xantippe	ENM:PER:1ST
Zelzate	Zelzate	ENM:LOC:PTS
Afghaans	Afghaans	BNW:STL:ONV
Afghaanse	Afghaans	BNW:STL:VRB
Afghaanse	Afghaanse	ZNW:EKV:DE_
Afrikaans	Afrikaans	BNW:STL:ONV
Afrikaans	Afrikaans	ZNW:EKV:HET
Afrikaanse	Afrikaans	BNW:STL:VRB
Afrikaanse	Afrikaanse	ZNW:EKV:DE_
Amsterdams	Amsterdams	BNW:STL:ONV
Amsterdamse	Amsterdams	BNW:STL:VRB
Amsterdamse	Amsterdamse	ZNW:EKV:DE_
NCRV	NCRV	ZNW:EKV:DE_
Oosterschelde	Oosterschelde	ZNW:EKV:DE_
Vlaams	Vlaams	ZNW:EKV:HET
Zweeds-Spaans	Zweeds-Spaans	BNW:STL:ONV
Zwitsers-Italiaans	Zwitsers-Italiaans	BNW:STL:ONV
appuyeer	appuyeren	WKW:TGW:1EP
appuyeerde	appuyeren	WKW:VLT:1EP
appuyeerden	appuyeren	WKW:VLT:INF
appuyeert	appuyeren	WKW:TGW:3EP
appuyere	appuyeren	WKW:AWS
appuyeren	appuyeren	WKW:TGW:INF
appuyerend	appuyeren	WKW:ODW:ONV
appuyerende	appuyeren	WKW:ODW:VRB
appuyerenden	appuyeren	WKW:ODW:MRV:DE_
dat	dat	VGW:EKV:HET
dat	dat	VNW:AWZ:HET
dat	dat	VNW:OND:EKV:HET
deze	deze	VNW:OND:EKV:DE_
deze	deze	VNW:OND:MRV:DE_
die	die	VGW:EKV:DE_
die	die	VGW:MRV:DE_
dit	dit	VNW:AWZ:HET
dit	dit	VNW:OND:EKV:HET
geappuyeerd	appuyeren	WKW:VTD:ONV
geappuyeerde	appuyeren	WKW:VTD:VRB
geappuyeerden	appuyeren	WKW:VTD:MRV:DE_
groothandel	groothandel	ZNW:EKV:DE_
het	het	VNW:AWZ:HET
het	het	VNW:OND:EKV:HET
kan	kunnen	WKW:TGW:3EP
klooster	klooster	ZNW:EKV:HET
terug	terug	BYW
volgens	volgens	VRZ
weg	weg	BYW
wil	willen	WKW:TGW:3EP
zonder	zonder	VGW
zonder	zonder	VRZ
Abuja	Abuja	ENM:LOC:PTS
Accra	Accra	ENM:LOC:PTS
Afghanistan	Afghanistan	ENM:LOC:LND
Albanees	Albanees	ZNW:EKV:HET
Algerije	Algerije	ENM:LOC:LND
Algiers	Algiers	ENM:LOC:PTS
Angola	Angola	ENM:LOC:LND
Ankara	Ankara	ENM:LOC:PTS
Apia	Apia	ENM:LOC:PTS
Arabisch	Arabisch	ZNW:EKV:HET
Armeens	Armeens	ZNW:EKV:HET
Asjchabad	Asjchabad	ENM:LOC:PTS
Asmara	Asmara	ENM:LOC:PTS
Astana	Astana	ENM:LOC:PTS
Bagdad	Bagdad	ENM:LOC:PTS
Bahrein	Bahrein	ENM:LOC:LND
Bakoe	Bakoe	ENM:LOC:PTS
Bamako	Bamako	ENM:LOC:PTS
Bangui	Bangui	ENM:LOC:PTS
Banjul	Banjul	ENM:LOC:PTS
Barbados	Barbados	ENM:LOC:LND
Beijing	Beijing	ENM:LOC:PTS
Beiroet	Beiroet	ENM:LOC:PTS
Belgrado	Belgrado	ENM:LOC:PTS
Belize	Belize	ENM:LOC:LND
Belmopan	Belmopan	ENM:LOC:PTS
Bengaals	Bengaals	ZNW:EKV:HET
Benin	Benin	ENM:LOC:LND
Bhutan	Bhutan	ENM:LOC:LND
Birmees	Birmees	ZNW:EKV:HET
Bisjkek	Bisjkek	ENM:LOC:PTS
Bissau	Bissau	ENM:LOC:PTS
Boedapest	Boedapest	ENM:LOC:PTS
Bogota	Bogota	ENM:LOC:PTS
Bolivia	Bolivia	ENM:LOC:LND
Boston	Boston	ENM:LOC:PTS
Botswana	Botswana	ENM:LOC:LND
Brabant	Brabant	ENM:LOC:RGN
Brabants	Brabants	BNW:STL:ONV
Brabantse	Brabants	BNW:STL:VRB
Brabantse	Brabantse	ZNW:EKV:DE_
Brasilia	Brasilia	ENM:LOC:PTS
Brunei	Brunei	ENM:LOC:LND
Bujumbura	Bujumbura	ENM:LOC:PTS
Bulgaars	Bulgaars	ZNW:EKV:HET
Bulgarije	Bulgarije	ENM:LOC:LND
Burundi	Burundi	ENM:LOC:LND
Cambodja	Cambodja	ENM:LOC:LND
Canada	Canada	ENM:LOC:LND
Canberra	Canberra	ENM:LOC:PTS
Caracas	Caracas	ENM:LOC:PTS
Castries	Castries	ENM:LOC:PTS
Catalaans	Catalaans	ZNW:EKV:HET
Caïro	Caïro	ENM:LOC:PTS
Chisinau	Chisinau	ENM:LOC:PTS
Colombia	Colombia	ENM:LOC:LND
Comoren	Comoren	ENM:LOC:LND
Conakry	Conakry	ENM:LOC:PTS
Congo-Brazzaville	Congo-Brazzaville	ENM:LOC:LND
Congo-Kinshasa	Congo-Kinshasa	ENM:LOC:LND
Dhaka	Dhaka	ENM:LOC:PTS
Dodoma	Dodoma	ENM:LOC:PTS
Doesjanbe	Doesjanbe	ENM:LOC:PTS
Doha	Doha	ENM:LOC:PTS
Ecuador	Ecuador	ENM:LOC:LND
Engeland	Engeland	ENM:LOC:RGN
Equatoriaal-Guinea	Equatoriaal-Guinea	ENM:LOC:LND
Eritrea	Eritrea	ENM:LOC:LND
Europa	Europa	ENM:LOC:RGN
Frankrijk	Frankrijk	ENM:LOC:LND
Friesland	Friesland	ENM:LOC:RGN
Gabon	Gabon	ENM:LOC:LND
Gaborone	Gaborone	ENM:LOC:PTS
Gambia	Gambia	ENM:LOC:LND
Ghana	Ghana	ENM:LOC:LND
Grenada	Grenada	ENM:LOC:LND
Grieks	Grieks	ZNW:EKV:HET
Guatemala	Guatemala	ENM:LOC:LND
Guatemala-Stad	Guatemala-Stad	ENM:LOC:PTS
Guyana	Guyana	ENM:LOC:LND
Hanoi	Hanoi	ENM:LOC:PTS
Harare	Harare	ENM:LOC:PTS
Havana	Havana	ENM:LOC:PTS
Haïti	Haïti	ENM:LOC:LND
Hessen	Hessen	ENM:LOC:PTS
Honduras	Honduras	ENM:LOC:LND
Hongarije	Hongarije	ENM:LOC:LND
IJslands	IJslands	ZNW:EKV:HET
Irak	Irak	ENM:LOC:LND
Iran	Iran	ENM:LOC:LND
Israël	Israël	ENM:LOC:LND
Ivoorkust	Ivoorkust	ENM:LOC:LND
Jakarta	Jakarta	ENM:LOC:PTS
Jamaica	Jamaica	ENM:LOC:LND
Japan	Japan	ENM:LOC:LND
Java	Java	ENM:LOC:EIL
Jemen	Jemen	ENM:LOC:LND
Kaboel	Kaboel	ENM:LOC:PTS
Kampala	Kampala	ENM:LOC:PTS
Kenia	Kenia	ENM:LOC:LND
Khartoem	Khartoem	ENM:LOC:PTS
Kigali	Kigali	ENM:LOC:PTS
Kinshasa	Kinshasa	ENM:LOC:PTS
Kiribati	Kiribati	ENM:LOC:LND
Kopenhagen	Kopenhagen	ENM:LOC:PTS
Kroatisch	Kroatisch	ZNW:EKV:HET
Laos	Laos	ENM:LOC:LND
Libanon	Libanon	ENM:LOC:LND
Liberia	Liberia	ENM:LOC:LND
Lima	Lima	ENM:LOC:PTS
Ljubljana	Ljubljana	ENM:LOC:PTS
Lomé	Lomé	ENM:LOC:PTS
Luanda	Luanda	ENM:LOC:PTS
Lusaka	Lusaka	ENM:LOC:PTS
Luxemburg	Luxemburg	ENM:LOC:LND
Macedonisch	Macedonisch	ZNW:EKV:HET
Majuro	Majuro	ENM:LOC:PTS
Malabo	Malabo	ENM:LOC:PTS
Malawi	Malawi	ENM:LOC:LND
Malta	Malta	ENM:LOC:LND
Malé	Malé	ENM:LOC:PTS
Managua	Managua	ENM:LOC:PTS
Manilla	Manilla	ENM:LOC:PTS
Maputo	Maputo	ENM:LOC:PTS
Maseru	Maseru	ENM:LOC:PTS
Masqat	Masqat	ENM:LOC:PTS
Mbabane	Mbabane	ENM:LOC:PTS
Mexico-Stad	Mexico-Stad	ENM:LOC:PTS
Micronesia	Micronesia	ENM:LOC:LND
Minsk	Minsk	ENM:LOC:PTS
Monaco	Monaco	ENM:LOC:LND
Mongools	Mongools	ZNW:EKV:HET
Monrovia	Monrovia	ENM:LOC:PTS
Montenegrijns	Montenegrijns	ZNW:EKV:HET
Montenegro	Montenegro	ENM:LOC:LND
Montevideo	Montevideo	ENM:LOC:PTS
Moroni	Moroni	ENM:LOC:PTS
Nairobi	Nairobi	ENM:LOC:PTS
Nassau	Nassau	ENM:LOC:PTS
Nauru	Nauru	ENM:LOC:LND
Ndjamena	Ndjamena	ENM:LOC:PTS
Nepal	Nepal	ENM:LOC:LND
Nepalees	Nepalees	ZNW:EKV:HET
Niamey	Niamey	ENM:LOC:PTS
Nicosia	Nicosia	ENM:LOC:PTS
Nieuw-Zeeland	Nieuw-Zeeland	ENM:LOC:RGN
Niger	Niger	ENM:LOC:LND
Nigeria	Nigeria	ENM:LOC:LND
Noord-Korea	Noord-Korea	ENM:LOC:LND
Noorwegen	Noorwegen	ENM:LOC:LND
Nuku'alofa	Nuku'alofa	ENM:LOC:PTS
Oeganda	Oeganda	ENM:LOC:LND
Oekraïens	Oekraïens	ZNW:EKV:HET
Oekraïne	Oekraïne	ENM:LOC:LND
Oezbeeks	Oezbeeks	ZNW:EKV:HET
Oost-Timor	Oost-Timor	ENM:LOC:LND
Oslo	Oslo	ENM:LOC:PTS
Ottawa	Ottawa	ENM:LOC:PTS
Pakistan	Pakistan	ENM:LOC:LND
Palau	Palau	ENM:LOC:LND
Palestina	Palestina	ENM:LOC:LND
Palikir	Palikir	ENM:LOC:PTS
Panama-Stad	Panama-Stad	ENM:LOC:PTS
Papoea-Nieuw-Guinea	Papoea-Nieuw-Guinea	ENM:LOC:LND
Paraguay	Paraguay	ENM:LOC:LND
Paramaribo	Paramaribo	ENM:LOC:PTS
Parijs	Parijs	ENM:LOC:PTS
Peru	Peru	ENM:LOC:LND
Perzisch	Perzisch	ZNW:EKV:HET
Portugal	Portugal	ENM:LOC:LND
Praia	Praia	ENM:LOC:PTS
Pristina	Pristina	ENM:LOC:PTS
Qatar	Qatar	ENM:LOC:LND
Quito	Quito	ENM:LOC:PTS
Rabat	Rabat	ENM:LOC:PTS
Reykjavik	Reykjavik	ENM:LOC:PTS
Riga	Riga	ENM:LOC:PTS
Roemeens	Roemeens	ZNW:EKV:HET
Roseau	Roseau	ENM:LOC:PTS
Rwanda	Rwanda	ENM:LOC:LND
Samoa	Samoa	ENM:LOC:LND
Sarajevo	Sarajevo	ENM:LOC:PTS
Senegal	Senegal	ENM:LOC:LND
Seoul	Seoul	ENM:LOC:PTS
Seychellen	Seychellen	ENM:LOC:LND
Sloveens	Sloveens	ZNW:EKV:HET
Soedan	Soedan	ENM:LOC:LND
Sucre	Sucre	ENM:LOC:PTS
Suriname	Suriname	ENM:LOC:LND
Suva	Suva	ENM:LOC:PTS
Tallinn	Tallinn	ENM:LOC:PTS
Tanzania	Tanzania	ENM:LOC:LND
Tasjkent	Tasjkent	ENM:LOC:PTS
Tbilisi	Tbilisi	ENM:LOC:PTS
Teheran	Teheran	ENM:LOC:PTS
Thimphu	Thimphu	ENM:LOC:PTS
Tirana	Tirana	ENM:LOC:PTS
Togo	Togo	ENM:LOC:LND
Tokio	Tokio	ENM:LOC:PTS
Tonga	Tonga	ENM:LOC:LND
Tripoli	Tripoli	ENM:LOC:PTS
Tsjaad	Tsjaad	ENM:LOC:LND
Tunis	Tunis	ENM:LOC:PTS
Turkije	Turkije	ENM:LOC:LND
Turkmeens	Turkmeens	ZNW:EKV:HET
Turks	Turks	ZNW:EKV:HET
Tuvalu	Tuvalu	ENM:LOC:LND
Uruguay	Uruguay	ENM:LOC:LND
Vaduz	Vaduz	ENM:LOC:PTS
Valletta	Valletta	ENM:LOC:PTS
Vanuatu	Vanuatu	ENM:LOC:LND
Vaticaanstad	Vaticaanstad	ENM:LOC:PTS
Venezuela	Venezuela	ENM:LOC:LND
Vientiane	Vientiane	ENM:LOC:PTS
Vietnam	Vietnam	ENM:LOC:LND
Vietnamees	Vietnamees	ZNW:EKV:HET
Vilnius	Vilnius	ENM:LOC:PTS
Warschau	Warschau	ENM:LOC:PTS
Windhoek	Windhoek	ENM:LOC:PTS
Yamoussoukro	Yamoussoukro	ENM:LOC:PTS
Yaoundé	Yaoundé	ENM:LOC:PTS
Zagreb	Zagreb	ENM:LOC:PTS
Zambia	Zambia	ENM:LOC:LND
Zimbabwe	Zimbabwe	ENM:LOC:LND
Zuid-Afrika	Zuid-Afrika	ENM:LOC:LND
Zuid-Korea	Zuid-Korea	ENM:LOC:LND
Zweeds	Zweeds	ZNW:EKV:HET
salarisstroken	salarisstrook	ZNW:MRV:DE_
Ierland	Ierland	ENM:LOC:LND
